PokerStars Hand #240965075293: Tournament #3527430994, $0.92+$0.08 USD Hold'em No Limit - Level I (10/20) - 2023/01/06 20:01:12 ET
Table '3527430994 1' 3-max Seat #1 is the button
Seat 1: mikomo35 (500 in chips) 
Seat 2: Lorpugo (500 in chips) 
Seat 3: nizzybiz (500 in chips) 
Lorpugo: posts small blind 10
nizzybiz: posts big blind 20
*** HOLE CARDS ***
Dealt to Lorpugo [6c 2c]
mikomo35: folds 
Lorpugo: raises 80 to 100
nizzybiz: calls 80
*** FLOP *** [Kh Th 2h]
Lorpugo: bets 400 and is all-in
nizzybiz: folds 
Uncalled bet (400) returned to Lorpugo
Lorpugo collected 200 from pot
Lorpugo: doesn't show hand 
*** SUMMARY ***
Total pot 200 | Rake 0 
Board [Kh Th 2h]
Seat 1: mikomo35 (button) folded before Flop (didn't bet)
Seat 2: Lorpugo (small blind) collected (200)
Seat 3: nizzybiz (big blind) folded on the Flop



PokerStars Hand #240965081447: Tournament #3527430994, $0.92+$0.08 USD Hold'em No Limit - Level I (10/20) - 2023/01/06 20:01:34 ET
Table '3527430994 1' 3-max Seat #2 is the button
Seat 1: mikomo35 (500 in chips) 
Seat 2: Lorpugo (600 in chips) 
Seat 3: nizzybiz (400 in chips) 
nizzybiz: posts small blind 10
mikomo35: posts big blind 20
*** HOLE CARDS ***
Dealt to Lorpugo [As 4s]
Lorpugo: raises 80 to 100
nizzybiz: calls 90
mikomo35: folds 
*** FLOP *** [Jh 3c Tc]
nizzybiz: checks 
Lorpugo: bets 500 and is all-in
nizzybiz: calls 300 and is all-in
Uncalled bet (200) returned to Lorpugo
*** TURN *** [Jh 3c Tc] [Js]
*** RIVER *** [Jh 3c Tc Js] [3d]
*** SHOW DOWN ***
nizzybiz: shows [Ts 8s] (two pair, Jacks and Tens)
Lorpugo: shows [As 4s] (two pair, Jacks and Threes)
nizzybiz collected 820 from pot
*** SUMMARY ***
Total pot 820 | Rake 0 
Board [Jh 3c Tc Js 3d]
Seat 1: mikomo35 (big blind) folded before Flop
Seat 2: Lorpugo (button) showed [As 4s] and lost with two pair, Jacks and Threes
Seat 3: nizzybiz (small blind) showed [Ts 8s] and won (820) with two pair, Jacks and Tens



PokerStars Hand #240965088336: Tournament #3527430994, $0.92+$0.08 USD Hold'em No Limit - Level I (10/20) - 2023/01/06 20:01:59 ET
Table '3527430994 1' 3-max Seat #3 is the button
Seat 1: mikomo35 (480 in chips) 
Seat 2: Lorpugo (200 in chips) 
Seat 3: nizzybiz (820 in chips) 
mikomo35: posts small blind 10
Lorpugo: posts big blind 20
*** HOLE CARDS ***
Dealt to Lorpugo [Kd 8c]
nizzybiz: calls 20
mikomo35: folds 
Lorpugo: raises 180 to 200 and is all-in
nizzybiz: calls 180
*** FLOP *** [Js 5c Kh]
*** TURN *** [Js 5c Kh] [3d]
*** RIVER *** [Js 5c Kh 3d] [5d]
*** SHOW DOWN ***
Lorpugo: shows [Kd 8c] (two pair, Kings and Fives)
nizzybiz: shows [7h Jc] (two pair, Jacks and Fives)
Lorpugo collected 410 from pot
*** SUMMARY ***
Total pot 410 | Rake 0 
Board [Js 5c Kh 3d 5d]
Seat 1: mikomo35 (small blind) folded before Flop
Seat 2: Lorpugo (big blind) showed [Kd 8c] and won (410) with two pair, Kings and Fives
Seat 3: nizzybiz (button) showed [7h Jc] and lost with two pair, Jacks and Fives



PokerStars Hand #240965094741: Tournament #3527430994, $0.92+$0.08 USD Hold'em No Limit - Level I (10/20) - 2023/01/06 20:02:22 ET
Table '3527430994 1' 3-max Seat #1 is the button
Seat 1: mikomo35 (470 in chips) 
Seat 2: Lorpugo (410 in chips) 
Seat 3: nizzybiz (620 in chips) 
Lorpugo: posts small blind 10
nizzybiz: posts big blind 20
*** HOLE CARDS ***
Dealt to Lorpugo [7c 5d]
mikomo35: folds 
Lorpugo: raises 30 to 50
nizzybiz: calls 30
*** FLOP *** [8d 5s Jh]
Lorpugo: bets 40
nizzybiz: calls 40
*** TURN *** [8d 5s Jh] [Kh]
Lorpugo: bets 320 and is all-in
nizzybiz: folds 
Uncalled bet (320) returned to Lorpugo
Lorpugo collected 180 from pot
Lorpugo: doesn't show hand 
*** SUMMARY ***
Total pot 180 | Rake 0 
Board [8d 5s Jh Kh]
Seat 1: mikomo35 (button) folded before Flop (didn't bet)
Seat 2: Lorpugo (small blind) collected (180)
Seat 3: nizzybiz (big blind) folded on the Turn



PokerStars Hand #240965101559: Tournament #3527430994, $0.92+$0.08 USD Hold'em No Limit - Level I (10/20) - 2023/01/06 20:02:46 ET
Table '3527430994 1' 3-max Seat #2 is the button
Seat 1: mikomo35 (470 in chips) 
Seat 2: Lorpugo (500 in chips) 
Seat 3: nizzybiz (530 in chips) 
nizzybiz: posts small blind 10
mikomo35: posts big blind 20
*** HOLE CARDS ***
Dealt to Lorpugo [6s Qh]
Lorpugo: folds 
nizzybiz: calls 10
mikomo35: checks 
*** FLOP *** [Ah 9d Js]
nizzybiz: checks 
mikomo35: bets 20
nizzybiz: calls 20
*** TURN *** [Ah 9d Js] [Kh]
nizzybiz: checks 
mikomo35: checks 
*** RIVER *** [Ah 9d Js Kh] [Kc]
nizzybiz: bets 40
mikomo35: folds 
Uncalled bet (40) returned to nizzybiz
nizzybiz collected 80 from pot
nizzybiz: doesn't show hand 
*** SUMMARY ***
Total pot 80 | Rake 0 
Board [Ah 9d Js Kh Kc]
Seat 1: mikomo35 (big blind) folded on the River
Seat 2: Lorpugo (button) folded before Flop (didn't bet)
Seat 3: nizzybiz (small blind) collected (80)



PokerStars Hand #240965110348: Tournament #3527430994, $0.92+$0.08 USD Hold'em No Limit - Level I (10/20) - 2023/01/06 20:03:17 ET
Table '3527430994 1' 3-max Seat #3 is the button
Seat 1: mikomo35 (430 in chips) 
Seat 2: Lorpugo (500 in chips) 
Seat 3: nizzybiz (570 in chips) 
mikomo35: posts small blind 10
Lorpugo: posts big blind 20
*** HOLE CARDS ***
Dealt to Lorpugo [2d Td]
nizzybiz: calls 20
mikomo35: calls 10
Lorpugo: checks 
*** FLOP *** [8s 5d Ac]
mikomo35: checks 
Lorpugo: bets 80
nizzybiz: folds 
mikomo35: folds 
Uncalled bet (80) returned to Lorpugo
Lorpugo collected 60 from pot
Lorpugo: doesn't show hand 
*** SUMMARY ***
Total pot 60 | Rake 0 
Board [8s 5d Ac]
Seat 1: mikomo35 (small blind) folded on the Flop
Seat 2: Lorpugo (big blind) collected (60)
Seat 3: nizzybiz (button) folded on the Flop



PokerStars Hand #240965117566: Tournament #3527430994, $0.92+$0.08 USD Hold'em No Limit - Level I (10/20) - 2023/01/06 20:03:43 ET
Table '3527430994 1' 3-max Seat #1 is the button
Seat 1: mikomo35 (410 in chips) 
Seat 2: Lorpugo (540 in chips) 
Seat 3: nizzybiz (550 in chips) 
Lorpugo: posts small blind 10
nizzybiz: posts big blind 20
*** HOLE CARDS ***
Dealt to Lorpugo [Td 7d]
mikomo35: folds 
Lorpugo: raises 30 to 50
nizzybiz: calls 30
*** FLOP *** [2c 4c Kd]
Lorpugo: bets 66
nizzybiz: folds 
Uncalled bet (66) returned to Lorpugo
Lorpugo collected 100 from pot
Lorpugo: doesn't show hand 
*** SUMMARY ***
Total pot 100 | Rake 0 
Board [2c 4c Kd]
Seat 1: mikomo35 (button) folded before Flop (didn't bet)
Seat 2: Lorpugo (small blind) collected (100)
Seat 3: nizzybiz (big blind) folded on the Flop



PokerStars Hand #240965124747: Tournament #3527430994, $0.92+$0.08 USD Hold'em No Limit - Level I (10/20) - 2023/01/06 20:04:08 ET
Table '3527430994 1' 3-max Seat #2 is the button
Seat 1: mikomo35 (410 in chips) 
Seat 2: Lorpugo (590 in chips) 
Seat 3: nizzybiz (500 in chips) 
nizzybiz: posts small blind 10
mikomo35: posts big blind 20
*** HOLE CARDS ***
Dealt to Lorpugo [8h Jd]
Lorpugo: raises 20 to 40
nizzybiz: calls 30
mikomo35: folds 
*** FLOP *** [8c Qh 7h]
nizzybiz: checks 
Lorpugo: bets 60
nizzybiz: calls 60
*** TURN *** [8c Qh 7h] [8s]
nizzybiz: checks 
Lorpugo: bets 120
nizzybiz: calls 120
*** RIVER *** [8c Qh 7h 8s] [5h]
nizzybiz: bets 280 and is all-in
Lorpugo: calls 280
*** SHOW DOWN ***
nizzybiz: shows [9d Th] (a pair of Eights)
Lorpugo: shows [8h Jd] (three of a kind, Eights)
Lorpugo collected 1020 from pot
nizzybiz finished the tournament in 3rd place
*** SUMMARY ***
Total pot 1020 | Rake 0 
Board [8c Qh 7h 8s 5h]
Seat 1: mikomo35 (big blind) folded before Flop
Seat 2: Lorpugo (button) showed [8h Jd] and won (1020) with three of a kind, Eights
Seat 3: nizzybiz (small blind) showed [9d Th] and lost with a pair of Eights



PokerStars Hand #240965136973: Tournament #3527430994, $0.92+$0.08 USD Hold'em No Limit - Level II (15/30) - 2023/01/06 20:04:52 ET
Table '3527430994 1' 3-max Seat #1 is the button
Seat 1: mikomo35 (390 in chips) 
Seat 2: Lorpugo (1110 in chips) 
mikomo35: posts small blind 15
Lorpugo: posts big blind 30
*** HOLE CARDS ***
Dealt to Lorpugo [6s Ac]
mikomo35: raises 360 to 390 and is all-in
Lorpugo: calls 360
*** FLOP *** [Ad 2h Jd]
*** TURN *** [Ad 2h Jd] [Qc]
*** RIVER *** [Ad 2h Jd Qc] [4c]
*** SHOW DOWN ***
Lorpugo: shows [6s Ac] (a pair of Aces)
mikomo35: shows [3d 3c] (a pair of Threes)
Lorpugo collected 780 from pot
mikomo35 finished the tournament in 2nd place
Lorpugo wins the tournament and receives $3.00 - congratulations!
*** SUMMARY ***
Total pot 780 | Rake 0 
Board [Ad 2h Jd Qc 4c]
Seat 1: mikomo35 (button) (small blind) showed [3d 3c] and lost with a pair of Threes
Seat 2: Lorpugo (big blind) showed [6s Ac] and won (780) with a pair of Aces



