PokerStars Hand #240775713571:  Hold'em No Limit ($0.01/$0.02 USD) - 2022/12/29 11:47:57 ET
Table 'Idelsonia II' 6-max Seat #1 is the button
Seat 1: sky858 ($2 in chips) 
Seat 2: Sonyland ($1.09 in chips) 
Seat 3: Lorpugo ($1.60 in chips) 
Seat 4: KAWABANGADU06 ($0.35 in chips) 
Seat 5: Michajunior01 ($0.88 in chips) 
Seat 6: marcio14 ($2.19 in chips) 
Sonyland: posts small blind $0.01
Lorpugo: posts big blind $0.02
*** HOLE CARDS ***
Dealt to Lorpugo [Jc Qd]
KAWABANGADU06: raises $0.33 to $0.35 and is all-in
Michajunior01: folds 
marcio14: folds 
sky858: folds 
Sonyland: folds 
Lorpugo: folds 
Uncalled bet ($0.33) returned to KAWABANGADU06
KAWABANGADU06 collected $0.05 from pot
*** SUMMARY ***
Total pot $0.05 | Rake $0 
Seat 1: sky858 (button) folded before Flop (didn't bet)
Seat 2: Sonyland (small blind) folded before Flop
Seat 3: Lorpugo (big blind) folded before Flop
Seat 4: KAWABANGADU06 collected ($0.05)
Seat 5: Michajunior01 folded before Flop (didn't bet)
Seat 6: marcio14 folded before Flop (didn't bet)



PokerStars Hand #240775719495:  Hold'em No Limit ($0.01/$0.02 USD) - 2022/12/29 11:48:14 ET
Table 'Idelsonia II' 6-max Seat #2 is the button
Seat 1: sky858 ($2 in chips) 
Seat 2: Sonyland ($1.08 in chips) 
Seat 3: Lorpugo ($1.58 in chips) 
Seat 4: KAWABANGADU06 ($0.38 in chips) 
Seat 5: Michajunior01 ($0.88 in chips) 
Seat 6: marcio14 ($2.19 in chips) 
Lorpugo: posts small blind $0.01
KAWABANGADU06: posts big blind $0.02
*** HOLE CARDS ***
Dealt to Lorpugo [Jd 4h]
Michajunior01: folds 
marcio14: folds 
sky858: folds 
Sonyland: folds 
Lorpugo: folds 
Uncalled bet ($0.01) returned to KAWABANGADU06
KAWABANGADU06 collected $0.02 from pot
*** SUMMARY ***
Total pot $0.02 | Rake $0 
Seat 1: sky858 folded before Flop (didn't bet)
Seat 2: Sonyland (button) folded before Flop (didn't bet)
Seat 3: Lorpugo (small blind) folded before Flop
Seat 4: KAWABANGADU06 (big blind) collected ($0.02)
Seat 5: Michajunior01 folded before Flop (didn't bet)
Seat 6: marcio14 folded before Flop (didn't bet)



PokerStars Hand #240775724907:  Hold'em No Limit ($0.01/$0.02 USD) - 2022/12/29 11:48:30 ET
Table 'Idelsonia II' 6-max Seat #3 is the button
Seat 1: sky858 ($2 in chips) 
Seat 2: Sonyland ($1.08 in chips) 
Seat 3: Lorpugo ($1.57 in chips) 
Seat 4: KAWABANGADU06 ($0.39 in chips) 
Seat 5: Michajunior01 ($0.88 in chips) 
Seat 6: marcio14 ($2.19 in chips) 
KAWABANGADU06: posts small blind $0.01
Michajunior01: posts big blind $0.02
*** HOLE CARDS ***
Dealt to Lorpugo [Ks 5s]
marcio14: folds 
sky858: folds 
Sonyland: folds 
Lorpugo: raises $0.04 to $0.06
KAWABANGADU06: calls $0.05
Michajunior01: calls $0.04
*** FLOP *** [Th 6d Ts]
KAWABANGADU06: checks 
Michajunior01: checks 
Lorpugo: bets $0.06
KAWABANGADU06: calls $0.06
Michajunior01: folds 
*** TURN *** [Th 6d Ts] [Jc]
KAWABANGADU06: checks 
Lorpugo: bets $0.24
KAWABANGADU06: folds 
Uncalled bet ($0.24) returned to Lorpugo
Lorpugo collected $0.29 from pot
Lorpugo: doesn't show hand 
*** SUMMARY ***
Total pot $0.30 | Rake $0.01 
Board [Th 6d Ts Jc]
Seat 1: sky858 folded before Flop (didn't bet)
Seat 2: Sonyland folded before Flop (didn't bet)
Seat 3: Lorpugo (button) collected ($0.29)
Seat 4: KAWABANGADU06 (small blind) folded on the Turn
Seat 5: Michajunior01 (big blind) folded on the Flop
Seat 6: marcio14 folded before Flop (didn't bet)



PokerStars Hand #240775742810:  Hold'em No Limit ($0.01/$0.02 USD) - 2022/12/29 11:49:23 ET
Table 'Idelsonia II' 6-max Seat #4 is the button
Seat 1: sky858 ($2 in chips) 
Seat 2: Sonyland ($1.08 in chips) 
Seat 3: Lorpugo ($1.74 in chips) 
Seat 4: KAWABANGADU06 ($0.27 in chips) 
Seat 5: Michajunior01 ($0.82 in chips) 
Seat 6: marcio14 ($2.19 in chips) 
Michajunior01: posts small blind $0.01
marcio14: posts big blind $0.02
*** HOLE CARDS ***
Dealt to Lorpugo [Qs 3s]
sky858: folds 
Sonyland: folds 
Lorpugo: folds 
KAWABANGADU06: calls $0.02
Michajunior01: folds 
marcio14: checks 
*** FLOP *** [6d 3c 6h]
marcio14: checks 
KAWABANGADU06: bets $0.02
marcio14: folds 
Uncalled bet ($0.02) returned to KAWABANGADU06
KAWABANGADU06 collected $0.05 from pot
*** SUMMARY ***
Total pot $0.05 | Rake $0 
Board [6d 3c 6h]
Seat 1: sky858 folded before Flop (didn't bet)
Seat 2: Sonyland folded before Flop (didn't bet)
Seat 3: Lorpugo folded before Flop (didn't bet)
Seat 4: KAWABANGADU06 (button) collected ($0.05)
Seat 5: Michajunior01 (small blind) folded before Flop
Seat 6: marcio14 (big blind) folded on the Flop



PokerStars Hand #240775752165:  Hold'em No Limit ($0.01/$0.02 USD) - 2022/12/29 11:49:51 ET
Table 'Idelsonia II' 6-max Seat #5 is the button
Seat 1: sky858 ($2 in chips) 
Seat 2: Sonyland ($1.08 in chips) 
Seat 3: Lorpugo ($1.74 in chips) 
Seat 4: KAWABANGADU06 ($0.30 in chips) 
Seat 5: Michajunior01 ($0.81 in chips) 
sky858: posts small blind $0.01
Sonyland: posts big blind $0.02
*** HOLE CARDS ***
Dealt to Lorpugo [7c Tc]
Lorpugo: folds 
marcio14 leaves the table
KAWABANGADU06: calls $0.02
Michajunior01: folds 
sky858: folds 
opiciprdel joins the table at seat #6 
Sonyland: checks 
*** FLOP *** [5s Js 8s]
Sonyland: checks 
KAWABANGADU06: checks 
*** TURN *** [5s Js 8s] [Jh]
Sonyland: checks 
KAWABANGADU06: checks 
*** RIVER *** [5s Js 8s Jh] [2h]
Sonyland: checks 
KAWABANGADU06: checks 
*** SHOW DOWN ***
Sonyland: shows [6d Kd] (a pair of Jacks)
KAWABANGADU06: mucks hand 
Sonyland collected $0.05 from pot
*** SUMMARY ***
Total pot $0.05 | Rake $0 
Board [5s Js 8s Jh 2h]
Seat 1: sky858 (small blind) folded before Flop
Seat 2: Sonyland (big blind) showed [6d Kd] and won ($0.05) with a pair of Jacks
Seat 3: Lorpugo folded before Flop (didn't bet)
Seat 4: KAWABANGADU06 mucked [7h Qh]
Seat 5: Michajunior01 (button) folded before Flop (didn't bet)



PokerStars Hand #240775760496:  Hold'em No Limit ($0.01/$0.02 USD) - 2022/12/29 11:50:17 ET
Table 'Idelsonia II' 6-max Seat #1 is the button
Seat 1: sky858 ($2 in chips) 
Seat 2: Sonyland ($1.11 in chips) 
Seat 3: Lorpugo ($1.74 in chips) 
Seat 4: KAWABANGADU06 ($0.28 in chips) 
Seat 5: Michajunior01 ($0.81 in chips) 
Seat 6: opiciprdel ($1.60 in chips) 
Sonyland: posts small blind $0.01
Lorpugo: posts big blind $0.02
opiciprdel: posts big blind $0.02
*** HOLE CARDS ***
Dealt to Lorpugo [6h 9d]
KAWABANGADU06: raises $0.02 to $0.04
Michajunior01: folds 
opiciprdel: calls $0.02
sky858: folds 
Sonyland: folds 
Lorpugo: calls $0.02
*** FLOP *** [5h Kc 7d]
Lorpugo: checks 
KAWABANGADU06: bets $0.02
opiciprdel: calls $0.02
Lorpugo: calls $0.02
*** TURN *** [5h Kc 7d] [4h]
Lorpugo: checks 
KAWABANGADU06: bets $0.12
opiciprdel: folds 
Lorpugo: calls $0.12
*** RIVER *** [5h Kc 7d 4h] [Jc]
Lorpugo: checks 
KAWABANGADU06: bets $0.10 and is all-in
Lorpugo: folds 
Uncalled bet ($0.10) returned to KAWABANGADU06
KAWABANGADU06 collected $0.41 from pot
*** SUMMARY ***
Total pot $0.43 | Rake $0.02 
Board [5h Kc 7d 4h Jc]
Seat 1: sky858 (button) folded before Flop (didn't bet)
Seat 2: Sonyland (small blind) folded before Flop
Seat 3: Lorpugo (big blind) folded on the River
Seat 4: KAWABANGADU06 collected ($0.41)
Seat 5: Michajunior01 folded before Flop (didn't bet)
Seat 6: opiciprdel folded on the Turn



PokerStars Hand #240775777931:  Hold'em No Limit ($0.01/$0.02 USD) - 2022/12/29 11:51:09 ET
Table 'Idelsonia II' 6-max Seat #2 is the button
Seat 1: sky858 ($2 in chips) 
Seat 2: Sonyland ($1.10 in chips) 
Seat 3: Lorpugo ($1.56 in chips) 
Seat 4: KAWABANGADU06 ($0.51 in chips) 
Seat 5: Michajunior01 ($0.81 in chips) 
Seat 6: opiciprdel ($1.54 in chips) 
Lorpugo: posts small blind $0.01
KAWABANGADU06: posts big blind $0.02
*** HOLE CARDS ***
Dealt to Lorpugo [3c 7d]
Michajunior01: folds 
opiciprdel: calls $0.02
sky858: folds 
Sonyland: folds 
Lorpugo: folds 
KAWABANGADU06: checks 
*** FLOP *** [7s Ad Qh]
KAWABANGADU06: bets $0.02
opiciprdel: calls $0.02
*** TURN *** [7s Ad Qh] [Kd]
KAWABANGADU06: checks 
opiciprdel: bets $0.04
KAWABANGADU06: folds 
Uncalled bet ($0.04) returned to opiciprdel
opiciprdel collected $0.09 from pot
*** SUMMARY ***
Total pot $0.09 | Rake $0 
Board [7s Ad Qh Kd]
Seat 1: sky858 folded before Flop (didn't bet)
Seat 2: Sonyland (button) folded before Flop (didn't bet)
Seat 3: Lorpugo (small blind) folded before Flop
Seat 4: KAWABANGADU06 (big blind) folded on the Turn
Seat 5: Michajunior01 folded before Flop (didn't bet)
Seat 6: opiciprdel collected ($0.09)



PokerStars Hand #240775787486:  Hold'em No Limit ($0.01/$0.02 USD) - 2022/12/29 11:51:38 ET
Table 'Idelsonia II' 6-max Seat #3 is the button
Seat 1: sky858 ($2 in chips) 
Seat 2: Sonyland ($1.10 in chips) 
Seat 3: Lorpugo ($1.55 in chips) 
Seat 4: KAWABANGADU06 ($0.47 in chips) 
Seat 5: Michajunior01 ($0.81 in chips) 
Seat 6: opiciprdel ($1.59 in chips) 
KAWABANGADU06: posts small blind $0.01
Michajunior01: posts big blind $0.02
*** HOLE CARDS ***
Dealt to Lorpugo [Ah 7s]
opiciprdel: calls $0.02
sky858: folds 
Sonyland: folds 
Lorpugo: calls $0.02
KAWABANGADU06: calls $0.01
Michajunior01: checks 
*** FLOP *** [Td Qc Qh]
KAWABANGADU06: checks 
Michajunior01: checks 
opiciprdel: checks 
Lorpugo: checks 
*** TURN *** [Td Qc Qh] [8h]
KAWABANGADU06: checks 
Michajunior01: checks 
opiciprdel: bets $0.04
Lorpugo: folds 
KAWABANGADU06: folds 
Michajunior01: folds 
Uncalled bet ($0.04) returned to opiciprdel
opiciprdel collected $0.08 from pot
*** SUMMARY ***
Total pot $0.08 | Rake $0 
Board [Td Qc Qh 8h]
Seat 1: sky858 folded before Flop (didn't bet)
Seat 2: Sonyland folded before Flop (didn't bet)
Seat 3: Lorpugo (button) folded on the Turn
Seat 4: KAWABANGADU06 (small blind) folded on the Turn
Seat 5: Michajunior01 (big blind) folded on the Turn
Seat 6: opiciprdel collected ($0.08)



PokerStars Hand #240775800794:  Hold'em No Limit ($0.01/$0.02 USD) - 2022/12/29 11:52:18 ET
Table 'Idelsonia II' 6-max Seat #4 is the button
Seat 1: sky858 ($2 in chips) 
Seat 2: Sonyland ($1.10 in chips) 
Seat 3: Lorpugo ($1.53 in chips) 
Seat 4: KAWABANGADU06 ($0.45 in chips) 
Seat 5: Michajunior01 ($0.79 in chips) 
Seat 6: opiciprdel ($1.65 in chips) 
Michajunior01: posts small blind $0.01
opiciprdel: posts big blind $0.02
*** HOLE CARDS ***
Dealt to Lorpugo [Ac 8c]
sky858: folds 
Sonyland: folds 
Lorpugo: raises $0.04 to $0.06
KAWABANGADU06: folds 
Michajunior01: raises $0.14 to $0.20
opiciprdel: folds 
Lorpugo: folds 
Uncalled bet ($0.14) returned to Michajunior01
Michajunior01 collected $0.14 from pot
*** SUMMARY ***
Total pot $0.14 | Rake $0 
Seat 1: sky858 folded before Flop (didn't bet)
Seat 2: Sonyland folded before Flop (didn't bet)
Seat 3: Lorpugo folded before Flop
Seat 4: KAWABANGADU06 (button) folded before Flop (didn't bet)
Seat 5: Michajunior01 (small blind) collected ($0.14)
Seat 6: opiciprdel (big blind) folded before Flop



PokerStars Hand #240775812400:  Hold'em No Limit ($0.01/$0.02 USD) - 2022/12/29 11:52:53 ET
Table 'Idelsonia II' 6-max Seat #5 is the button
Seat 1: sky858 ($2 in chips) 
Seat 2: Sonyland ($1.10 in chips) 
Seat 3: Lorpugo ($1.47 in chips) 
Seat 4: KAWABANGADU06 ($0.45 in chips) 
Seat 5: Michajunior01 ($0.87 in chips) 
Seat 6: opiciprdel ($1.63 in chips) 
opiciprdel: posts small blind $0.01
sky858: posts big blind $0.02
*** HOLE CARDS ***
Dealt to Lorpugo [7h Tc]
Sonyland: folds 
Lorpugo: folds 
KAWABANGADU06: folds 
Michajunior01: raises $0.05 to $0.07
opiciprdel: folds 
sky858: folds 
Uncalled bet ($0.05) returned to Michajunior01
Michajunior01 collected $0.05 from pot
*** SUMMARY ***
Total pot $0.05 | Rake $0 
Seat 1: sky858 (big blind) folded before Flop
Seat 2: Sonyland folded before Flop (didn't bet)
Seat 3: Lorpugo folded before Flop (didn't bet)
Seat 4: KAWABANGADU06 folded before Flop (didn't bet)
Seat 5: Michajunior01 (button) collected ($0.05)
Seat 6: opiciprdel (small blind) folded before Flop



PokerStars Hand #240775822063:  Hold'em No Limit ($0.01/$0.02 USD) - 2022/12/29 11:53:22 ET
Table 'Idelsonia II' 6-max Seat #6 is the button
Seat 1: sky858 ($2 in chips) 
Seat 2: Sonyland ($1.10 in chips) 
Seat 3: Lorpugo ($1.47 in chips) 
Seat 4: KAWABANGADU06 ($0.45 in chips) 
Seat 5: Michajunior01 ($0.90 in chips) 
Seat 6: opiciprdel ($1.62 in chips) 
sky858: posts small blind $0.01
Sonyland: posts big blind $0.02
*** HOLE CARDS ***
Dealt to Lorpugo [2c 7s]
Lorpugo: folds 
KAWABANGADU06: folds 
Michajunior01: folds 
opiciprdel: calls $0.02
sky858: raises $0.06 to $0.08
Sonyland: folds 
opiciprdel: calls $0.06
*** FLOP *** [3s Kd 8h]
sky858: checks 
opiciprdel: bets $0.04
sky858: folds 
Uncalled bet ($0.04) returned to opiciprdel
opiciprdel collected $0.17 from pot
*** SUMMARY ***
Total pot $0.18 | Rake $0.01 
Board [3s Kd 8h]
Seat 1: sky858 (small blind) folded on the Flop
Seat 2: Sonyland (big blind) folded before Flop
Seat 3: Lorpugo folded before Flop (didn't bet)
Seat 4: KAWABANGADU06 folded before Flop (didn't bet)
Seat 5: Michajunior01 folded before Flop (didn't bet)
Seat 6: opiciprdel (button) collected ($0.17)



PokerStars Hand #240775833682:  Hold'em No Limit ($0.01/$0.02 USD) - 2022/12/29 11:53:57 ET
Table 'Idelsonia II' 6-max Seat #1 is the button
Seat 1: sky858 ($2 in chips) 
Seat 2: Sonyland ($1.08 in chips) 
Seat 3: Lorpugo ($1.47 in chips) 
Seat 4: KAWABANGADU06 ($0.45 in chips) 
Seat 5: Michajunior01 ($0.90 in chips) 
Seat 6: opiciprdel ($1.71 in chips) 
Sonyland: posts small blind $0.01
Lorpugo: posts big blind $0.02
*** HOLE CARDS ***
Dealt to Lorpugo [Ks 9d]
KAWABANGADU06: folds 
Michajunior01: folds 
opiciprdel: calls $0.02
sky858: raises $0.07 to $0.09
Sonyland: folds 
Lorpugo: folds 
opiciprdel: calls $0.07
*** FLOP *** [Th Kd 8h]
opiciprdel: checks 
sky858: bets $0.10
opiciprdel: calls $0.10
*** TURN *** [Th Kd 8h] [As]
opiciprdel: checks 
sky858: bets $0.20
opiciprdel: folds 
Uncalled bet ($0.20) returned to sky858
sky858 collected $0.40 from pot
sky858: doesn't show hand 
*** SUMMARY ***
Total pot $0.41 | Rake $0.01 
Board [Th Kd 8h As]
Seat 1: sky858 (button) collected ($0.40)
Seat 2: Sonyland (small blind) folded before Flop
Seat 3: Lorpugo (big blind) folded before Flop
Seat 4: KAWABANGADU06 folded before Flop (didn't bet)
Seat 5: Michajunior01 folded before Flop (didn't bet)
Seat 6: opiciprdel folded on the Turn



PokerStars Hand #240775846523:  Hold'em No Limit ($0.01/$0.02 USD) - 2022/12/29 11:54:35 ET
Table 'Idelsonia II' 6-max Seat #2 is the button
Seat 1: sky858 ($2.21 in chips) 
Seat 2: Sonyland ($1.07 in chips) 
Seat 3: Lorpugo ($1.45 in chips) 
Seat 4: KAWABANGADU06 ($0.45 in chips) 
Seat 5: Michajunior01 ($0.90 in chips) 
Seat 6: opiciprdel ($1.52 in chips) 
Lorpugo: posts small blind $0.01
KAWABANGADU06: posts big blind $0.02
*** HOLE CARDS ***
Dealt to Lorpugo [8c 4c]
Michajunior01: folds 
opiciprdel: calls $0.02
sky858: folds 
Sonyland: folds 
Lorpugo: folds 
KAWABANGADU06: raises $0.04 to $0.06
opiciprdel: calls $0.04
*** FLOP *** [3h 6h Jc]
KAWABANGADU06: bets $0.06
opiciprdel: folds 
Uncalled bet ($0.06) returned to KAWABANGADU06
KAWABANGADU06 collected $0.13 from pot
*** SUMMARY ***
Total pot $0.13 | Rake $0 
Board [3h 6h Jc]
Seat 1: sky858 folded before Flop (didn't bet)
Seat 2: Sonyland (button) folded before Flop (didn't bet)
Seat 3: Lorpugo (small blind) folded before Flop
Seat 4: KAWABANGADU06 (big blind) collected ($0.13)
Seat 5: Michajunior01 folded before Flop (didn't bet)
Seat 6: opiciprdel folded on the Flop



PokerStars Hand #240775857737:  Hold'em No Limit ($0.01/$0.02 USD) - 2022/12/29 11:55:09 ET
Table 'Idelsonia II' 6-max Seat #3 is the button
Seat 1: sky858 ($2.21 in chips) 
Seat 2: Sonyland ($1.07 in chips) 
Seat 3: Lorpugo ($1.44 in chips) 
Seat 4: KAWABANGADU06 ($0.52 in chips) 
Seat 5: Michajunior01 ($0.90 in chips) 
Seat 6: opiciprdel ($1.46 in chips) 
KAWABANGADU06: posts small blind $0.01
Michajunior01: posts big blind $0.02
*** HOLE CARDS ***
Dealt to Lorpugo [Kd 9d]
opiciprdel: calls $0.02
sky858: folds 
Sonyland: folds 
Lorpugo: calls $0.02
KAWABANGADU06: folds 
Michajunior01: checks 
*** FLOP *** [Ts 8c 7c]
Michajunior01: checks 
opiciprdel: bets $0.04
Lorpugo: calls $0.04
Michajunior01: folds 
*** TURN *** [Ts 8c 7c] [Qc]
opiciprdel: bets $0.04
Lorpugo: calls $0.04
*** RIVER *** [Ts 8c 7c Qc] [3s]
opiciprdel: bets $0.10
Lorpugo: folds 
Uncalled bet ($0.10) returned to opiciprdel
opiciprdel collected $0.22 from pot
*** SUMMARY ***
Total pot $0.23 | Rake $0.01 
Board [Ts 8c 7c Qc 3s]
Seat 1: sky858 folded before Flop (didn't bet)
Seat 2: Sonyland folded before Flop (didn't bet)
Seat 3: Lorpugo (button) folded on the River
Seat 4: KAWABANGADU06 (small blind) folded before Flop
Seat 5: Michajunior01 (big blind) folded on the Flop
Seat 6: opiciprdel collected ($0.22)



PokerStars Hand #240775870232:  Hold'em No Limit ($0.01/$0.02 USD) - 2022/12/29 11:55:58 ET
Table 'Idelsonia II' 6-max Seat #4 is the button
Seat 1: sky858 ($2.21 in chips) 
Seat 2: Sonyland ($1.07 in chips) 
Seat 3: Lorpugo ($1.34 in chips) 
Seat 4: KAWABANGADU06 ($0.51 in chips) 
Seat 5: Michajunior01 ($0.88 in chips) 
Seat 6: opiciprdel ($1.58 in chips) 
Michajunior01: posts small blind $0.01
opiciprdel: posts big blind $0.02
*** HOLE CARDS ***
Dealt to Lorpugo [5s 7s]
sky858: folds 
Sonyland: folds 
Lorpugo: raises $0.04 to $0.06
KAWABANGADU06: folds 
Michajunior01: calls $0.05
opiciprdel: folds 
*** FLOP *** [3s As Ks]
Michajunior01: bets $0.14
Lorpugo: raises $0.21 to $0.35
Michajunior01: calls $0.21
*** TURN *** [3s As Ks] [9h]
Michajunior01: bets $0.47 and is all-in
Lorpugo: calls $0.47
*** RIVER *** [3s As Ks 9h] [Jc]
*** SHOW DOWN ***
Michajunior01: shows [Ac 8d] (a pair of Aces)
Lorpugo: shows [5s 7s] (a flush, Ace high)
Lorpugo collected $1.72 from pot
*** SUMMARY ***
Total pot $1.78 | Rake $0.06 
Board [3s As Ks 9h Jc]
Seat 1: sky858 folded before Flop (didn't bet)
Seat 2: Sonyland folded before Flop (didn't bet)
Seat 3: Lorpugo showed [5s 7s] and won ($1.72) with a flush, Ace high
Seat 4: KAWABANGADU06 (button) folded before Flop (didn't bet)
Seat 5: Michajunior01 (small blind) showed [Ac 8d] and lost with a pair of Aces
Seat 6: opiciprdel (big blind) folded before Flop



PokerStars Hand #240775883198:  Hold'em No Limit ($0.01/$0.02 USD) - 2022/12/29 11:56:48 ET
Table 'Idelsonia II' 6-max Seat #6 is the button
Seat 1: sky858 ($2.21 in chips) 
Seat 2: Sonyland ($1.07 in chips) 
Seat 3: Lorpugo ($2.18 in chips) 
Seat 4: KAWABANGADU06 ($0.51 in chips) 
Seat 6: opiciprdel ($1.56 in chips) 
sky858: posts small blind $0.01
Sonyland: posts big blind $0.02
*** HOLE CARDS ***
Dealt to Lorpugo [5c 6d]
Michajunior01 leaves the table
Lorpugo has timed out
Lorpugo: folds 
KAWABANGADU06: folds 
opiciprdel has timed out
opiciprdel: folds 
sky858: folds 
Uncalled bet ($0.01) returned to Sonyland
Sonyland collected $0.02 from pot
Sonyland: doesn't show hand 
*** SUMMARY ***
Total pot $0.02 | Rake $0 
Seat 1: sky858 (small blind) folded before Flop
Seat 2: Sonyland (big blind) collected ($0.02)
Seat 3: Lorpugo folded before Flop (didn't bet)
Seat 4: KAWABANGADU06 folded before Flop (didn't bet)
Seat 6: opiciprdel (button) folded before Flop (didn't bet)



PokerStars Hand #240775890850:  Hold'em No Limit ($0.01/$0.02 USD) - 2022/12/29 11:57:17 ET
Table 'Idelsonia II' 6-max Seat #1 is the button
Seat 1: sky858 ($2.20 in chips) 
Seat 2: Sonyland ($1.08 in chips) 
Seat 3: Lorpugo ($2.18 in chips) 
Seat 4: KAWABANGADU06 ($0.51 in chips) 
Sonyland: posts small blind $0.01
Lorpugo: posts big blind $0.02
*** HOLE CARDS ***
Dealt to Lorpugo [9h 2s]
KAWABANGADU06: raises $0.02 to $0.04
Josema_holdem joins the table at seat #5 
sky858: folds 
Sonyland: folds 
Lorpugo: folds 
Uncalled bet ($0.02) returned to KAWABANGADU06
KAWABANGADU06 collected $0.05 from pot
*** SUMMARY ***
Total pot $0.05 | Rake $0 
Seat 1: sky858 (button) folded before Flop (didn't bet)
Seat 2: Sonyland (small blind) folded before Flop
Seat 3: Lorpugo (big blind) folded before Flop
Seat 4: KAWABANGADU06 collected ($0.05)



PokerStars Hand #240775894946:  Hold'em No Limit ($0.01/$0.02 USD) - 2022/12/29 11:57:33 ET
Table 'Idelsonia II' 6-max Seat #2 is the button
Seat 1: sky858 ($2.20 in chips) 
Seat 2: Sonyland ($1.07 in chips) 
Seat 3: Lorpugo ($2.16 in chips) 
Seat 4: KAWABANGADU06 ($0.54 in chips) 
Lorpugo: posts small blind $0.01
KAWABANGADU06: posts big blind $0.02
*** HOLE CARDS ***
Dealt to Lorpugo [7d 8h]
sky858: folds 
Sonyland: folds 
Lorpugo: raises $0.04 to $0.06
KAWABANGADU06: calls $0.04
*** FLOP *** [Kc Ks 6h]
Lorpugo: bets $0.04
KAWABANGADU06: raises $0.04 to $0.08
Lorpugo: calls $0.04
*** TURN *** [Kc Ks 6h] [2s]
Lorpugo: checks 
KAWABANGADU06: bets $0.10
Lorpugo: folds 
Uncalled bet ($0.10) returned to KAWABANGADU06
KAWABANGADU06 collected $0.27 from pot
*** SUMMARY ***
Total pot $0.28 | Rake $0.01 
Board [Kc Ks 6h 2s]
Seat 1: sky858 folded before Flop (didn't bet)
Seat 2: Sonyland (button) folded before Flop (didn't bet)
Seat 3: Lorpugo (small blind) folded on the Turn
Seat 4: KAWABANGADU06 (big blind) collected ($0.27)



PokerStars Hand #240775903286:  Hold'em No Limit ($0.01/$0.02 USD) - 2022/12/29 11:58:05 ET
Table 'Idelsonia II' 6-max Seat #3 is the button
Seat 1: sky858 ($2.20 in chips) 
Seat 2: Sonyland ($1.07 in chips) 
Seat 3: Lorpugo ($2.02 in chips) 
Seat 4: KAWABANGADU06 ($0.67 in chips) 
Seat 5: Josema_holdem ($2 in chips) 
Seat 6: opiciprdel ($1.56 in chips) 
KAWABANGADU06: posts small blind $0.01
Josema_holdem: posts big blind $0.02
*** HOLE CARDS ***
Dealt to Lorpugo [8h 9h]
opiciprdel: folds 
sky858: folds 
Sonyland: folds 
Lorpugo: raises $0.04 to $0.06
KAWABANGADU06: folds 
Josema_holdem: folds 
Uncalled bet ($0.04) returned to Lorpugo
Lorpugo collected $0.05 from pot
Lorpugo: doesn't show hand 
*** SUMMARY ***
Total pot $0.05 | Rake $0 
Seat 1: sky858 folded before Flop (didn't bet)
Seat 2: Sonyland folded before Flop (didn't bet)
Seat 3: Lorpugo (button) collected ($0.05)
Seat 4: KAWABANGADU06 (small blind) folded before Flop
Seat 5: Josema_holdem (big blind) folded before Flop
Seat 6: opiciprdel folded before Flop (didn't bet)



PokerStars Hand #240775907825:  Hold'em No Limit ($0.01/$0.02 USD) - 2022/12/29 11:58:22 ET
Table 'Idelsonia II' 6-max Seat #4 is the button
Seat 1: sky858 ($2.20 in chips) 
Seat 2: Sonyland ($1.07 in chips) 
Seat 3: Lorpugo ($2.05 in chips) 
Seat 4: KAWABANGADU06 ($0.66 in chips) 
Seat 5: Josema_holdem ($1.98 in chips) 
Seat 6: opiciprdel ($1.56 in chips) 
Josema_holdem: posts small blind $0.01
opiciprdel: posts big blind $0.02
*** HOLE CARDS ***
Dealt to Lorpugo [2d Jd]
sky858: folds 
Sonyland: folds 
Lorpugo: folds 
KAWABANGADU06: folds 
Josema_holdem: calls $0.01
opiciprdel: checks 
*** FLOP *** [9d 2s 5h]
Josema_holdem: bets $0.04
opiciprdel: calls $0.04
*** TURN *** [9d 2s 5h] [4d]
Josema_holdem: bets $0.10
opiciprdel: calls $0.10
*** RIVER *** [9d 2s 5h 4d] [Ad]
Josema_holdem: bets $0.02
opiciprdel: calls $0.02
*** SHOW DOWN ***
Josema_holdem: shows [9c Td] (a pair of Nines)
opiciprdel: mucks hand 
Josema_holdem collected $0.35 from pot
*** SUMMARY ***
Total pot $0.36 | Rake $0.01 
Board [9d 2s 5h 4d Ad]
Seat 1: sky858 folded before Flop (didn't bet)
Seat 2: Sonyland folded before Flop (didn't bet)
Seat 3: Lorpugo folded before Flop (didn't bet)
Seat 4: KAWABANGADU06 (button) folded before Flop (didn't bet)
Seat 5: Josema_holdem (small blind) showed [9c Td] and won ($0.35) with a pair of Nines
Seat 6: opiciprdel (big blind) mucked [6h 4c]



PokerStars Hand #240775915710:  Hold'em No Limit ($0.01/$0.02 USD) - 2022/12/29 11:58:52 ET
Table 'Idelsonia II' 6-max Seat #5 is the button
Seat 1: sky858 ($2.20 in chips) 
Seat 2: Sonyland ($1.07 in chips) 
Seat 3: Lorpugo ($2.05 in chips) 
Seat 4: KAWABANGADU06 ($0.66 in chips) 
Seat 5: Josema_holdem ($2.15 in chips) 
Seat 6: opiciprdel ($1.38 in chips) 
opiciprdel: posts small blind $0.01
sky858: posts big blind $0.02
*** HOLE CARDS ***
Dealt to Lorpugo [Ad 2h]
Sonyland: folds 
Lorpugo: folds 
KAWABANGADU06: calls $0.02
Josema_holdem: folds 
Josema_holdem leaves the table
opiciprdel: calls $0.01
sky858: checks 
*** FLOP *** [Kh 8c Ts]
303:808 joins the table at seat #5 
opiciprdel: checks 
sky858: checks 
KAWABANGADU06: checks 
*** TURN *** [Kh 8c Ts] [Ac]
opiciprdel: bets $0.04
sky858: folds 
KAWABANGADU06: calls $0.04
*** RIVER *** [Kh 8c Ts Ac] [5d]
opiciprdel: bets $0.06
KAWABANGADU06: folds 
Uncalled bet ($0.06) returned to opiciprdel
opiciprdel collected $0.14 from pot
*** SUMMARY ***
Total pot $0.14 | Rake $0 
Board [Kh 8c Ts Ac 5d]
Seat 1: sky858 (big blind) folded on the Turn
Seat 2: Sonyland folded before Flop (didn't bet)
Seat 3: Lorpugo folded before Flop (didn't bet)
Seat 4: KAWABANGADU06 folded on the River
Seat 5: Josema_holdem (button) folded before Flop (didn't bet)
Seat 6: opiciprdel (small blind) collected ($0.14)



PokerStars Hand #240775925025:  Hold'em No Limit ($0.01/$0.02 USD) - 2022/12/29 11:59:29 ET
Table 'Idelsonia II' 6-max Seat #6 is the button
Seat 1: sky858 ($2.18 in chips) 
Seat 2: Sonyland ($1.07 in chips) 
Seat 3: Lorpugo ($2.05 in chips) 
Seat 4: KAWABANGADU06 ($0.60 in chips) 
Seat 6: opiciprdel ($1.46 in chips) 
sky858: posts small blind $0.01
Sonyland: posts big blind $0.02
*** HOLE CARDS ***
Dealt to Lorpugo [6c Ks]
Lorpugo: folds 
KAWABANGADU06: calls $0.02
opiciprdel: calls $0.02
sky858: folds 
Sonyland: checks 
*** FLOP *** [4s Ah Kc]
Sonyland: checks 
KAWABANGADU06: bets $0.04
opiciprdel: calls $0.04
Sonyland: folds 
*** TURN *** [4s Ah Kc] [9d]
KAWABANGADU06: checks 
opiciprdel: bets $0.08
KAWABANGADU06: folds 
Uncalled bet ($0.08) returned to opiciprdel
opiciprdel collected $0.14 from pot
*** SUMMARY ***
Total pot $0.15 | Rake $0.01 
Board [4s Ah Kc 9d]
Seat 1: sky858 (small blind) folded before Flop
Seat 2: Sonyland (big blind) folded on the Flop
Seat 3: Lorpugo folded before Flop (didn't bet)
Seat 4: KAWABANGADU06 folded on the Turn
Seat 6: opiciprdel (button) collected ($0.14)



PokerStars Hand #240775933571:  Hold'em No Limit ($0.01/$0.02 USD) - 2022/12/29 12:00:01 ET
Table 'Idelsonia II' 6-max Seat #1 is the button
Seat 1: sky858 ($2.17 in chips) 
Seat 2: Sonyland ($1.05 in chips) 
Seat 3: Lorpugo ($2.05 in chips) 
Seat 4: KAWABANGADU06 ($0.54 in chips) 
Seat 6: opiciprdel ($1.54 in chips) 
Sonyland: posts small blind $0.01
Lorpugo: posts big blind $0.02
*** HOLE CARDS ***
Dealt to Lorpugo [4s 2c]
KAWABANGADU06: folds 
opiciprdel: folds 
sky858: folds 
opiciprdel is disconnected 
Sonyland: folds 
Uncalled bet ($0.01) returned to Lorpugo
Lorpugo collected $0.02 from pot
Lorpugo: doesn't show hand 
*** SUMMARY ***
Total pot $0.02 | Rake $0 
Seat 1: sky858 (button) folded before Flop (didn't bet)
Seat 2: Sonyland (small blind) folded before Flop
Seat 3: Lorpugo (big blind) collected ($0.02)
Seat 4: KAWABANGADU06 folded before Flop (didn't bet)
Seat 6: opiciprdel folded before Flop (didn't bet)



PokerStars Hand #240775935466:  Hold'em No Limit ($0.01/$0.02 USD) - 2022/12/29 12:00:09 ET
Table 'Idelsonia II' 6-max Seat #2 is the button
Seat 1: sky858 ($2.17 in chips) 
Seat 2: Sonyland ($1.04 in chips) 
Seat 3: Lorpugo ($2.06 in chips) 
Seat 4: KAWABANGADU06 ($0.54 in chips) 
Seat 6: opiciprdel ($1.54 in chips) 
Lorpugo: posts small blind $0.01
KAWABANGADU06: posts big blind $0.02
*** HOLE CARDS ***
Dealt to Lorpugo [5h 2h]
opiciprdel has timed out while disconnected
opiciprdel: folds 
sky858: folds 
Sonyland: folds 
Lorpugo: folds 
Uncalled bet ($0.01) returned to KAWABANGADU06
KAWABANGADU06 collected $0.02 from pot
*** SUMMARY ***
Total pot $0.02 | Rake $0 
Seat 1: sky858 folded before Flop (didn't bet)
Seat 2: Sonyland (button) folded before Flop (didn't bet)
Seat 3: Lorpugo (small blind) folded before Flop
Seat 4: KAWABANGADU06 (big blind) collected ($0.02)
Seat 6: opiciprdel folded before Flop (didn't bet)



PokerStars Hand #240775939982:  Hold'em No Limit ($0.01/$0.02 USD) - 2022/12/29 12:00:26 ET
Table 'Idelsonia II' 6-max Seat #3 is the button
Seat 1: sky858 ($2.17 in chips) 
Seat 2: Sonyland ($1.04 in chips) 
Seat 3: Lorpugo ($2.05 in chips) 
Seat 4: KAWABANGADU06 ($0.55 in chips) 
Seat 5: 303:808 ($2 in chips) 
KAWABANGADU06: posts small blind $0.01
303:808: posts big blind $0.02
*** HOLE CARDS ***
Dealt to Lorpugo [Ac 5c]
sky858: folds 
Sonyland: folds 
Lorpugo: raises $0.04 to $0.06
KAWABANGADU06: calls $0.05
303:808: calls $0.04
*** FLOP *** [Ks 6c 8s]
KAWABANGADU06: checks 
303:808: checks 
Lorpugo: bets $0.02
KAWABANGADU06: calls $0.02
303:808: calls $0.02
*** TURN *** [Ks 6c 8s] [Kd]
KAWABANGADU06: checks 
303:808: checks 
Lorpugo: checks 
*** RIVER *** [Ks 6c 8s Kd] [6d]
KAWABANGADU06: checks 
303:808: checks 
Lorpugo: bets $0.02
KAWABANGADU06: folds 
303:808: calls $0.02
*** SHOW DOWN ***
Lorpugo: shows [Ac 5c] (two pair, Kings and Sixes)
303:808: shows [8h 7c] (two pair, Kings and Eights)
303:808 collected $0.27 from pot
*** SUMMARY ***
Total pot $0.28 | Rake $0.01 
Board [Ks 6c 8s Kd 6d]
Seat 1: sky858 folded before Flop (didn't bet)
Seat 2: Sonyland folded before Flop (didn't bet)
Seat 3: Lorpugo (button) showed [Ac 5c] and lost with two pair, Kings and Sixes
Seat 4: KAWABANGADU06 (small blind) folded on the River
Seat 5: 303:808 (big blind) showed [8h 7c] and won ($0.27) with two pair, Kings and Eights



PokerStars Hand #240775957567:  Hold'em No Limit ($0.01/$0.02 USD) - 2022/12/29 12:01:26 ET
Table 'Idelsonia II' 6-max Seat #4 is the button
Seat 1: sky858 ($2.17 in chips) 
Seat 2: Sonyland ($1.04 in chips) 
Seat 3: Lorpugo ($1.95 in chips) 
Seat 4: KAWABANGADU06 ($0.47 in chips) 
Seat 5: 303:808 ($2.17 in chips) 
303:808: posts small blind $0.01
sky858: posts big blind $0.02
*** HOLE CARDS ***
Dealt to Lorpugo [2h 3c]
Sonyland: raises $0.06 to $0.08
Lorpugo: folds 
KAWABANGADU06: folds 
303:808: folds 
sky858: folds 
Uncalled bet ($0.06) returned to Sonyland
Sonyland collected $0.05 from pot
Sonyland: doesn't show hand 
*** SUMMARY ***
Total pot $0.05 | Rake $0 
Seat 1: sky858 (big blind) folded before Flop
Seat 2: Sonyland collected ($0.05)
Seat 3: Lorpugo folded before Flop (didn't bet)
Seat 4: KAWABANGADU06 (button) folded before Flop (didn't bet)
Seat 5: 303:808 (small blind) folded before Flop



PokerStars Hand #240775960765:  Hold'em No Limit ($0.01/$0.02 USD) - 2022/12/29 12:01:36 ET
Table 'Idelsonia II' 6-max Seat #5 is the button
Seat 1: sky858 ($2.15 in chips) 
Seat 2: Sonyland ($1.07 in chips) 
Seat 3: Lorpugo ($1.95 in chips) 
Seat 4: KAWABANGADU06 ($0.47 in chips) 
Seat 5: 303:808 ($2.16 in chips) 
sky858: posts small blind $0.01
Sonyland: posts big blind $0.02
*** HOLE CARDS ***
Dealt to Lorpugo [Js 2h]
Lorpugo: folds 
KAWABANGADU06: raises $0.06 to $0.08
303:808: folds 
sky858: folds 
Sonyland: calls $0.06
*** FLOP *** [7d 4s Qd]
Sonyland: checks 
KAWABANGADU06: bets $0.08
Sonyland: folds 
Uncalled bet ($0.08) returned to KAWABANGADU06
KAWABANGADU06 collected $0.16 from pot
*** SUMMARY ***
Total pot $0.17 | Rake $0.01 
Board [7d 4s Qd]
Seat 1: sky858 (small blind) folded before Flop
Seat 2: Sonyland (big blind) folded on the Flop
Seat 3: Lorpugo folded before Flop (didn't bet)
Seat 4: KAWABANGADU06 collected ($0.16)
Seat 5: 303:808 (button) folded before Flop (didn't bet)



PokerStars Hand #240775972071:  Hold'em No Limit ($0.01/$0.02 USD) - 2022/12/29 12:02:10 ET
Table 'Idelsonia II' 6-max Seat #1 is the button
Seat 1: sky858 ($2.14 in chips) 
Seat 2: Sonyland ($0.99 in chips) 
Seat 3: Lorpugo ($1.95 in chips) 
Seat 4: KAWABANGADU06 ($0.55 in chips) 
Seat 5: 303:808 ($2.16 in chips) 
Sonyland: posts small blind $0.01
Lorpugo: posts big blind $0.02
*** HOLE CARDS ***
Dealt to Lorpugo [Qs Ac]
KAWABANGADU06: calls $0.02
303:808: folds 
sky858: folds 
Sonyland: raises $0.06 to $0.08
Lorpugo: raises $1.87 to $1.95 and is all-in
KAWABANGADU06: folds 
Sonyland: folds 
Uncalled bet ($1.87) returned to Lorpugo
Lorpugo collected $0.18 from pot
Lorpugo: doesn't show hand 
*** SUMMARY ***
Total pot $0.18 | Rake $0 
Seat 1: sky858 (button) folded before Flop (didn't bet)
Seat 2: Sonyland (small blind) folded before Flop
Seat 3: Lorpugo (big blind) collected ($0.18)
Seat 4: KAWABANGADU06 folded before Flop
Seat 5: 303:808 folded before Flop (didn't bet)



PokerStars Hand #240775979554:  Hold'em No Limit ($0.01/$0.02 USD) - 2022/12/29 12:02:32 ET
Table 'Idelsonia II' 6-max Seat #2 is the button
Seat 1: sky858 ($2.14 in chips) 
Seat 2: Sonyland ($0.91 in chips) 
Seat 3: Lorpugo ($2.05 in chips) 
Seat 4: KAWABANGADU06 ($0.53 in chips) 
Seat 5: 303:808 ($2.16 in chips) 
Lorpugo: posts small blind $0.01
KAWABANGADU06: posts big blind $0.02
*** HOLE CARDS ***
Dealt to Lorpugo [8c 3c]
303:808: folds 
sky858: folds 
Sonyland: folds 
Lorpugo: folds 
Uncalled bet ($0.01) returned to KAWABANGADU06
KAWABANGADU06 collected $0.02 from pot
*** SUMMARY ***
Total pot $0.02 | Rake $0 
Seat 1: sky858 folded before Flop (didn't bet)
Seat 2: Sonyland (button) folded before Flop (didn't bet)
Seat 3: Lorpugo (small blind) folded before Flop
Seat 4: KAWABANGADU06 (big blind) collected ($0.02)
Seat 5: 303:808 folded before Flop (didn't bet)



PokerStars Hand #240775984083:  Hold'em No Limit ($0.01/$0.02 USD) - 2022/12/29 12:02:47 ET
Table 'Idelsonia II' 6-max Seat #3 is the button
Seat 1: sky858 ($2.14 in chips) 
Seat 2: Sonyland ($0.91 in chips) 
Seat 3: Lorpugo ($2.04 in chips) 
Seat 4: KAWABANGADU06 ($0.54 in chips) 
Seat 5: 303:808 ($2.16 in chips) 
KAWABANGADU06: posts small blind $0.01
303:808: posts big blind $0.02
*** HOLE CARDS ***
Dealt to Lorpugo [Jc Js]
sky858: folds 
Sonyland: raises $0.04 to $0.06
Lorpugo: raises $0.15 to $0.21
KAWABANGADU06: folds 
303:808: folds 
Sonyland: raises $0.70 to $0.91 and is all-in
Lorpugo: calls $0.70
*** FLOP *** [8d Qh 2s]
*** TURN *** [8d Qh 2s] [4c]
*** RIVER *** [8d Qh 2s 4c] [9d]
*** SHOW DOWN ***
Sonyland: shows [Ac Qc] (a pair of Queens)
Lorpugo: shows [Jc Js] (a pair of Jacks)
Sonyland cashed out the hand for $0.81 | Cash Out Fee $0.01
*** SUMMARY ***
Total pot $1.85 | Rake $0.06 
Board [8d Qh 2s 4c 9d]
Seat 1: sky858 folded before Flop (didn't bet)
Seat 2: Sonyland showed [Ac Qc] and won ($1.79) with a pair of Queens (pot not awarded as player cashed out)
Seat 3: Lorpugo (button) showed [Jc Js] and lost with a pair of Jacks
Seat 4: KAWABANGADU06 (small blind) folded before Flop
Seat 5: 303:808 (big blind) folded before Flop



PokerStars Hand #240775994697:  Hold'em No Limit ($0.01/$0.02 USD) - 2022/12/29 12:03:19 ET
Table 'Idelsonia II' 6-max Seat #4 is the button
Seat 1: sky858 ($2.14 in chips) 
Seat 2: Sonyland ($0.81 in chips) 
Seat 3: Lorpugo ($1.13 in chips) 
Seat 4: KAWABANGADU06 ($0.53 in chips) 
Seat 5: 303:808 ($2.14 in chips) 
303:808: posts small blind $0.01
sky858: posts big blind $0.02
*** HOLE CARDS ***
Dealt to Lorpugo [6h 9d]
Sonyland: folds 
Lorpugo: folds 
KAWABANGADU06: calls $0.02
303:808: folds 
sky858: checks 
*** FLOP *** [3s Js Qh]
sky858: checks 
KAWABANGADU06: bets $0.02
sky858: folds 
Uncalled bet ($0.02) returned to KAWABANGADU06
KAWABANGADU06 collected $0.05 from pot
*** SUMMARY ***
Total pot $0.05 | Rake $0 
Board [3s Js Qh]
Seat 1: sky858 (big blind) folded on the Flop
Seat 2: Sonyland folded before Flop (didn't bet)
Seat 3: Lorpugo folded before Flop (didn't bet)
Seat 4: KAWABANGADU06 (button) collected ($0.05)
Seat 5: 303:808 (small blind) folded before Flop



PokerStars Hand #240776000442:  Hold'em No Limit ($0.01/$0.02 USD) - 2022/12/29 12:03:36 ET
Table 'Idelsonia II' 6-max Seat #5 is the button
Seat 1: sky858 ($2.12 in chips) 
Seat 2: Sonyland ($0.81 in chips) 
Seat 3: Lorpugo ($1.93 in chips) 
Seat 4: KAWABANGADU06 ($0.56 in chips) 
Seat 5: 303:808 ($2.13 in chips) 
sky858: posts small blind $0.01
Sonyland: posts big blind $0.02
*** HOLE CARDS ***
Dealt to Lorpugo [7d 8c]
Lorpugo: folds 
KAWABANGADU06: raises $0.02 to $0.04
303:808: folds 
sky858: folds 
Sonyland: calls $0.02
*** FLOP *** [Qd As 3s]
Sonyland: checks 
KAWABANGADU06: bets $0.04
Sonyland: folds 
Uncalled bet ($0.04) returned to KAWABANGADU06
KAWABANGADU06 collected $0.09 from pot
*** SUMMARY ***
Total pot $0.09 | Rake $0 
Board [Qd As 3s]
Seat 1: sky858 (small blind) folded before Flop
Seat 2: Sonyland (big blind) folded on the Flop
Seat 3: Lorpugo folded before Flop (didn't bet)
Seat 4: KAWABANGADU06 collected ($0.09)
Seat 5: 303:808 (button) folded before Flop (didn't bet)



PokerStars Hand #240776008309:  Hold'em No Limit ($0.01/$0.02 USD) - 2022/12/29 12:03:59 ET
Table 'Idelsonia II' 6-max Seat #1 is the button
Seat 1: sky858 ($2.11 in chips) 
Seat 2: Sonyland ($0.80 in chips) 
Seat 3: Lorpugo ($1.93 in chips) 
Seat 4: KAWABANGADU06 ($0.61 in chips) 
Seat 5: 303:808 ($2.13 in chips) 
Sonyland: posts small blind $0.01
Lorpugo: posts big blind $0.02
*** HOLE CARDS ***
Dealt to Lorpugo [2c Ks]
KAWABANGADU06: calls $0.02
303:808: folds 
sky858: folds 
Sonyland: folds 
Lorpugo: checks 
*** FLOP *** [4s Jd Th]
Lorpugo: bets $0.02
KAWABANGADU06: calls $0.02
*** TURN *** [4s Jd Th] [Qh]
Lorpugo: checks 
KAWABANGADU06: bets $0.02
Lorpugo: folds 
Uncalled bet ($0.02) returned to KAWABANGADU06
KAWABANGADU06 collected $0.09 from pot
*** SUMMARY ***
Total pot $0.09 | Rake $0 
Board [4s Jd Th Qh]
Seat 1: sky858 (button) folded before Flop (didn't bet)
Seat 2: Sonyland (small blind) folded before Flop
Seat 3: Lorpugo (big blind) folded on the Turn
Seat 4: KAWABANGADU06 collected ($0.09)
Seat 5: 303:808 folded before Flop (didn't bet)



PokerStars Hand #240776015283:  Hold'em No Limit ($0.01/$0.02 USD) - 2022/12/29 12:04:19 ET
Table 'Idelsonia II' 6-max Seat #2 is the button
Seat 1: sky858 ($2.11 in chips) 
Seat 2: Sonyland ($0.80 in chips) 
Seat 3: Lorpugo ($1.89 in chips) 
Seat 4: KAWABANGADU06 ($0.66 in chips) 
Seat 5: 303:808 ($2.13 in chips) 
Lorpugo: posts small blind $0.01
KAWABANGADU06: posts big blind $0.02
*** HOLE CARDS ***
Dealt to Lorpugo [7h Ah]
303:808: folds 
sky858: folds 
Sonyland: folds 
Lorpugo: raises $0.04 to $0.06
KAWABANGADU06: folds 
Uncalled bet ($0.04) returned to Lorpugo
Lorpugo collected $0.04 from pot
Lorpugo: doesn't show hand 
*** SUMMARY ***
Total pot $0.04 | Rake $0 
Seat 1: sky858 folded before Flop (didn't bet)
Seat 2: Sonyland (button) folded before Flop (didn't bet)
Seat 3: Lorpugo (small blind) collected ($0.04)
Seat 4: KAWABANGADU06 (big blind) folded before Flop
Seat 5: 303:808 folded before Flop (didn't bet)



PokerStars Hand #240776019955:  Hold'em No Limit ($0.01/$0.02 USD) - 2022/12/29 12:04:33 ET
Table 'Idelsonia II' 6-max Seat #3 is the button
Seat 1: sky858 ($2.11 in chips) 
Seat 2: Sonyland ($0.80 in chips) 
Seat 3: Lorpugo ($1.91 in chips) 
Seat 4: KAWABANGADU06 ($0.64 in chips) 
Seat 5: 303:808 ($2.13 in chips) 
KAWABANGADU06: posts small blind $0.01
303:808: posts big blind $0.02
*** HOLE CARDS ***
Dealt to Lorpugo [4c 4h]
sky858: folds 
Sonyland: folds 
Lorpugo: raises $0.04 to $0.06
KAWABANGADU06: folds 
303:808: calls $0.04
*** FLOP *** [8c 8s 6c]
303:808: checks 
Lorpugo: bets $0.07
303:808: folds 
Uncalled bet ($0.07) returned to Lorpugo
Lorpugo collected $0.13 from pot
Lorpugo: doesn't show hand 
*** SUMMARY ***
Total pot $0.13 | Rake $0 
Board [8c 8s 6c]
Seat 1: sky858 folded before Flop (didn't bet)
Seat 2: Sonyland folded before Flop (didn't bet)
Seat 3: Lorpugo (button) collected ($0.13)
Seat 4: KAWABANGADU06 (small blind) folded before Flop
Seat 5: 303:808 (big blind) folded on the Flop



PokerStars Hand #240776031223:  Hold'em No Limit ($0.01/$0.02 USD) - 2022/12/29 12:05:06 ET
Table 'Idelsonia II' 6-max Seat #4 is the button
Seat 1: sky858 ($2.11 in chips) 
Seat 2: Sonyland ($0.80 in chips) 
Seat 3: Lorpugo ($1.98 in chips) 
Seat 4: KAWABANGADU06 ($0.63 in chips) 
Seat 5: 303:808 ($2.07 in chips) 
303:808: posts small blind $0.01
sky858: posts big blind $0.02
*** HOLE CARDS ***
Dealt to Lorpugo [5h 7c]
Sonyland: folds 
Lorpugo: folds 
KAWABANGADU06: raises $0.06 to $0.08
303:808: folds 
sky858: folds 
Uncalled bet ($0.06) returned to KAWABANGADU06
KAWABANGADU06 collected $0.05 from pot
*** SUMMARY ***
Total pot $0.05 | Rake $0 
Seat 1: sky858 (big blind) folded before Flop
Seat 2: Sonyland folded before Flop (didn't bet)
Seat 3: Lorpugo folded before Flop (didn't bet)
Seat 4: KAWABANGADU06 (button) collected ($0.05)
Seat 5: 303:808 (small blind) folded before Flop



PokerStars Hand #240776036408:  Hold'em No Limit ($0.01/$0.02 USD) - 2022/12/29 12:05:22 ET
Table 'Idelsonia II' 6-max Seat #5 is the button
Seat 1: sky858 ($2.09 in chips) 
Seat 2: Sonyland ($0.80 in chips) 
Seat 3: Lorpugo ($1.98 in chips) 
Seat 4: KAWABANGADU06 ($0.66 in chips) 
Seat 5: 303:808 ($2.06 in chips) 
sky858: posts small blind $0.01
Sonyland: posts big blind $0.02
*** HOLE CARDS ***
Dealt to Lorpugo [9d 9s]
Lorpugo: raises $0.04 to $0.06
KAWABANGADU06: folds 
303:808: folds 
sky858: folds 
Sonyland: folds 
Uncalled bet ($0.04) returned to Lorpugo
Lorpugo collected $0.05 from pot
Lorpugo: doesn't show hand 
*** SUMMARY ***
Total pot $0.05 | Rake $0 
Seat 1: sky858 (small blind) folded before Flop
Seat 2: Sonyland (big blind) folded before Flop
Seat 3: Lorpugo collected ($0.05)
Seat 4: KAWABANGADU06 folded before Flop (didn't bet)
Seat 5: 303:808 (button) folded before Flop (didn't bet)



PokerStars Hand #240776039837:  Hold'em No Limit ($0.01/$0.02 USD) - 2022/12/29 12:05:31 ET
Table 'Idelsonia II' 6-max Seat #1 is the button
Seat 1: sky858 ($2.08 in chips) 
Seat 2: Sonyland ($0.80 in chips) 
Seat 3: Lorpugo ($2.01 in chips) 
Seat 4: KAWABANGADU06 ($0.66 in chips) 
Seat 5: 303:808 ($2.06 in chips) 
Sonyland: posts small blind $0.01
Lorpugo: posts big blind $0.02
*** HOLE CARDS ***
Dealt to Lorpugo [7s Js]
KAWABANGADU06: folds 
303:808: folds 
sky858: folds 
Sonyland: folds 
Uncalled bet ($0.01) returned to Lorpugo
Lorpugo collected $0.02 from pot
Lorpugo: doesn't show hand 
*** SUMMARY ***
Total pot $0.02 | Rake $0 
Seat 1: sky858 (button) folded before Flop (didn't bet)
Seat 2: Sonyland (small blind) folded before Flop
Seat 3: Lorpugo (big blind) collected ($0.02)
Seat 4: KAWABANGADU06 folded before Flop (didn't bet)
Seat 5: 303:808 folded before Flop (didn't bet)



PokerStars Hand #240776042575:  Hold'em No Limit ($0.01/$0.02 USD) - 2022/12/29 12:05:39 ET
Table 'Idelsonia II' 6-max Seat #2 is the button
Seat 1: sky858 ($2.08 in chips) 
Seat 2: Sonyland ($0.80 in chips) 
Seat 3: Lorpugo ($2.02 in chips) 
Seat 4: KAWABANGADU06 ($0.66 in chips) 
Seat 5: 303:808 ($2.06 in chips) 
Lorpugo: posts small blind $0.01
KAWABANGADU06: posts big blind $0.02
*** HOLE CARDS ***
Dealt to Lorpugo [Kc 3s]
303:808: folds 
sky858: folds 
Sonyland: folds 
Lorpugo: raises $0.04 to $0.06
KAWABANGADU06: calls $0.04
*** FLOP *** [6d Qh 6c]
Lorpugo: checks 
KAWABANGADU06: bets $0.06
Lorpugo: folds 
Uncalled bet ($0.06) returned to KAWABANGADU06
KAWABANGADU06 collected $0.12 from pot
*** SUMMARY ***
Total pot $0.12 | Rake $0 
Board [6d Qh 6c]
Seat 1: sky858 folded before Flop (didn't bet)
Seat 2: Sonyland (button) folded before Flop (didn't bet)
Seat 3: Lorpugo (small blind) folded on the Flop
Seat 4: KAWABANGADU06 (big blind) collected ($0.12)
Seat 5: 303:808 folded before Flop (didn't bet)



PokerStars Hand #240776053173:  Hold'em No Limit ($0.01/$0.02 USD) - 2022/12/29 12:06:10 ET
Table 'Idelsonia II' 6-max Seat #3 is the button
Seat 1: sky858 ($2.08 in chips) 
Seat 2: Sonyland ($0.80 in chips) 
Seat 3: Lorpugo ($1.96 in chips) 
Seat 4: KAWABANGADU06 ($0.72 in chips) 
Seat 5: 303:808 ($2.06 in chips) 
KAWABANGADU06: posts small blind $0.01
303:808: posts big blind $0.02
*** HOLE CARDS ***
Dealt to Lorpugo [7d Qc]
sky858: folds 
Sonyland: raises $0.04 to $0.06
Lorpugo: folds 
KAWABANGADU06: folds 
303:808: folds 
Uncalled bet ($0.04) returned to Sonyland
Sonyland collected $0.05 from pot
Sonyland: doesn't show hand 
*** SUMMARY ***
Total pot $0.05 | Rake $0 
Seat 1: sky858 folded before Flop (didn't bet)
Seat 2: Sonyland collected ($0.05)
Seat 3: Lorpugo (button) folded before Flop (didn't bet)
Seat 4: KAWABANGADU06 (small blind) folded before Flop
Seat 5: 303:808 (big blind) folded before Flop



PokerStars Hand #240776060972:  Hold'em No Limit ($0.01/$0.02 USD) - 2022/12/29 12:06:33 ET
Table 'Idelsonia II' 6-max Seat #4 is the button
Seat 1: sky858 ($2.08 in chips) 
Seat 2: Sonyland ($0.83 in chips) 
Seat 3: Lorpugo ($1.96 in chips) 
Seat 4: KAWABANGADU06 ($0.71 in chips) 
Seat 5: 303:808 ($2.04 in chips) 
303:808: posts small blind $0.01
sky858: posts big blind $0.02
*** HOLE CARDS ***
Dealt to Lorpugo [6h 7d]
Sonyland: folds 
Lorpugo: folds 
KAWABANGADU06: folds 
303:808: folds 
Uncalled bet ($0.01) returned to sky858
sky858 collected $0.02 from pot
opiciprdel leaves the table
sky858: doesn't show hand 
*** SUMMARY ***
Total pot $0.02 | Rake $0 
Seat 1: sky858 (big blind) collected ($0.02)
Seat 2: Sonyland folded before Flop (didn't bet)
Seat 3: Lorpugo folded before Flop (didn't bet)
Seat 4: KAWABANGADU06 (button) folded before Flop (didn't bet)
Seat 5: 303:808 (small blind) folded before Flop



PokerStars Hand #240776064613:  Hold'em No Limit ($0.01/$0.02 USD) - 2022/12/29 12:06:44 ET
Table 'Idelsonia II' 6-max Seat #5 is the button
Seat 1: sky858 ($2.09 in chips) 
Seat 2: Sonyland ($0.83 in chips) 
Seat 3: Lorpugo ($1.96 in chips) 
Seat 4: KAWABANGADU06 ($0.71 in chips) 
Seat 5: 303:808 ($2.03 in chips) 
sky858: posts small blind $0.01
Sonyland: posts big blind $0.02
*** HOLE CARDS ***
Dealt to Lorpugo [Qh As]
Lorpugo: raises $0.04 to $0.06
KAWABANGADU06: calls $0.06
303:808: folds 
sky858: folds 
Sonyland: calls $0.04
*** FLOP *** [Jc Jd Qd]
Sonyland: checks 
Lorpugo: checks 
KAWABANGADU06: bets $0.06
Sonyland: calls $0.06
panpaniscus1 joins the table at seat #6 
Lorpugo: raises $0.12 to $0.18
KAWABANGADU06: calls $0.12
Sonyland: folds 
*** TURN *** [Jc Jd Qd] [5h]
Lorpugo: bets $1.72 and is all-in
KAWABANGADU06: folds [Tc Kc]
Uncalled bet ($1.72) returned to Lorpugo
Lorpugo collected $0.59 from pot
Lorpugo: doesn't show hand 
*** SUMMARY ***
Total pot $0.61 | Rake $0.02 
Board [Jc Jd Qd 5h]
Seat 1: sky858 (small blind) folded before Flop
Seat 2: Sonyland (big blind) folded on the Flop
Seat 3: Lorpugo collected ($0.59)
Seat 4: KAWABANGADU06 folded on the Turn
Seat 5: 303:808 (button) folded before Flop (didn't bet)



PokerStars Hand #240776079134:  Hold'em No Limit ($0.01/$0.02 USD) - 2022/12/29 12:07:27 ET
Table 'Idelsonia II' 6-max Seat #1 is the button
Seat 1: sky858 ($2.08 in chips) 
Seat 2: Sonyland ($0.80 in chips) 
Seat 3: Lorpugo ($2.31 in chips) 
Seat 4: KAWABANGADU06 ($0.47 in chips) 
Seat 5: 303:808 ($2.03 in chips) 
Sonyland: posts small blind $0.01
Lorpugo: posts big blind $0.02
*** HOLE CARDS ***
Dealt to Lorpugo [2s 6s]
KAWABANGADU06: calls $0.02
303:808: folds 
sky858: raises $0.07 to $0.09
Sonyland: folds 
Lorpugo: folds 
KAWABANGADU06: folds 
Uncalled bet ($0.07) returned to sky858
sky858 collected $0.07 from pot
sky858: doesn't show hand 
*** SUMMARY ***
Total pot $0.07 | Rake $0 
Seat 1: sky858 (button) collected ($0.07)
Seat 2: Sonyland (small blind) folded before Flop
Seat 3: Lorpugo (big blind) folded before Flop
Seat 4: KAWABANGADU06 folded before Flop
Seat 5: 303:808 folded before Flop (didn't bet)



PokerStars Hand #240776083570:  Hold'em No Limit ($0.01/$0.02 USD) - 2022/12/29 12:07:40 ET
Table 'Idelsonia II' 6-max Seat #2 is the button
Seat 1: sky858 ($2.13 in chips) 
Seat 2: Sonyland ($0.80 in chips) 
Seat 3: Lorpugo ($2.29 in chips) 
Seat 4: KAWABANGADU06 ($0.45 in chips) 
Seat 5: 303:808 ($2.03 in chips) 
Lorpugo: posts small blind $0.01
KAWABANGADU06: posts big blind $0.02
*** HOLE CARDS ***
Dealt to Lorpugo [7c Qd]
303:808: folds 
sky858: folds 
Sonyland: folds 
Lorpugo: raises $0.04 to $0.06
KAWABANGADU06: raises $0.39 to $0.45 and is all-in
Lorpugo: folds 
Uncalled bet ($0.39) returned to KAWABANGADU06
KAWABANGADU06 collected $0.12 from pot
*** SUMMARY ***
Total pot $0.12 | Rake $0 
Seat 1: sky858 folded before Flop (didn't bet)
Seat 2: Sonyland (button) folded before Flop (didn't bet)
Seat 3: Lorpugo (small blind) folded before Flop
Seat 4: KAWABANGADU06 (big blind) collected ($0.12)
Seat 5: 303:808 folded before Flop (didn't bet)



PokerStars Hand #240776088323:  Hold'em No Limit ($0.01/$0.02 USD) - 2022/12/29 12:07:54 ET
Table 'Idelsonia II' 6-max Seat #3 is the button
Seat 1: sky858 ($2.13 in chips) 
Seat 2: Sonyland ($0.80 in chips) 
Seat 3: Lorpugo ($2.23 in chips) 
Seat 4: KAWABANGADU06 ($0.51 in chips) 
Seat 5: 303:808 ($2.03 in chips) 
KAWABANGADU06: posts small blind $0.01
303:808: posts big blind $0.02
*** HOLE CARDS ***
Dealt to Lorpugo [6d 4h]
sky858: folds 
Sonyland: raises $0.04 to $0.06
Lorpugo: folds 
KAWABANGADU06: folds 
303:808: calls $0.04
*** FLOP *** [4c 7h Td]
303:808: checks 
Sonyland: bets $0.07
303:808: folds 
Uncalled bet ($0.07) returned to Sonyland
Sonyland collected $0.13 from pot
Sonyland: doesn't show hand 
*** SUMMARY ***
Total pot $0.13 | Rake $0 
Board [4c 7h Td]
Seat 1: sky858 folded before Flop (didn't bet)
Seat 2: Sonyland collected ($0.13)
Seat 3: Lorpugo (button) folded before Flop (didn't bet)
Seat 4: KAWABANGADU06 (small blind) folded before Flop
Seat 5: 303:808 (big blind) folded on the Flop



PokerStars Hand #240776094466:  Hold'em No Limit ($0.01/$0.02 USD) - 2022/12/29 12:08:12 ET
Table 'Idelsonia II' 6-max Seat #4 is the button
Seat 1: sky858 ($2.13 in chips) 
Seat 2: Sonyland ($0.87 in chips) 
Seat 3: Lorpugo ($2.23 in chips) 
Seat 4: KAWABANGADU06 ($0.50 in chips) 
Seat 5: 303:808 ($2 in chips) 
Seat 6: panpaniscus1 ($2 in chips) 
303:808: posts small blind $0.01
panpaniscus1: posts big blind $0.02
*** HOLE CARDS ***
Dealt to Lorpugo [4h Ks]
sky858: folds 
Sonyland: folds 
Lorpugo: folds 
KAWABANGADU06: folds 
303:808: folds 
Uncalled bet ($0.01) returned to panpaniscus1
panpaniscus1 collected $0.02 from pot
panpaniscus1: doesn't show hand 
*** SUMMARY ***
Total pot $0.02 | Rake $0 
Seat 1: sky858 folded before Flop (didn't bet)
Seat 2: Sonyland folded before Flop (didn't bet)
Seat 3: Lorpugo folded before Flop (didn't bet)
Seat 4: KAWABANGADU06 (button) folded before Flop (didn't bet)
Seat 5: 303:808 (small blind) folded before Flop
Seat 6: panpaniscus1 (big blind) collected ($0.02)



PokerStars Hand #240776098516:  Hold'em No Limit ($0.01/$0.02 USD) - 2022/12/29 12:08:24 ET
Table 'Idelsonia II' 6-max Seat #5 is the button
Seat 1: sky858 ($2.13 in chips) 
Seat 2: Sonyland ($0.87 in chips) 
Seat 3: Lorpugo ($2.23 in chips) 
Seat 4: KAWABANGADU06 ($0.50 in chips) 
Seat 5: 303:808 ($2 in chips) 
Seat 6: panpaniscus1 ($2.01 in chips) 
panpaniscus1: posts small blind $0.01
sky858: posts big blind $0.02
*** HOLE CARDS ***
Dealt to Lorpugo [6c Th]
Sonyland: folds 
Lorpugo: folds 
KAWABANGADU06: folds 
303:808: raises $0.03 to $0.05
panpaniscus1: folds 
sky858: folds 
Uncalled bet ($0.03) returned to 303:808
303:808 collected $0.05 from pot
303:808: doesn't show hand 
*** SUMMARY ***
Total pot $0.05 | Rake $0 
Seat 1: sky858 (big blind) folded before Flop
Seat 2: Sonyland folded before Flop (didn't bet)
Seat 3: Lorpugo folded before Flop (didn't bet)
Seat 4: KAWABANGADU06 folded before Flop (didn't bet)
Seat 5: 303:808 (button) collected ($0.05)
Seat 6: panpaniscus1 (small blind) folded before Flop



PokerStars Hand #240776105585:  Hold'em No Limit ($0.01/$0.02 USD) - 2022/12/29 12:08:45 ET
Table 'Idelsonia II' 6-max Seat #6 is the button
Seat 1: sky858 ($2.11 in chips) 
Seat 2: Sonyland ($0.87 in chips) 
Seat 3: Lorpugo ($2.23 in chips) 
Seat 4: KAWABANGADU06 ($0.50 in chips) 
Seat 5: 303:808 ($2.03 in chips) 
Seat 6: panpaniscus1 ($2 in chips) 
sky858: posts small blind $0.01
Sonyland: posts big blind $0.02
*** HOLE CARDS ***
Dealt to Lorpugo [Qs 8c]
Lorpugo: folds 
KAWABANGADU06: calls $0.02
303:808: folds 
panpaniscus1: raises $0.04 to $0.06
sky858: calls $0.05
Sonyland: folds 
KAWABANGADU06: calls $0.04
*** FLOP *** [9s 2c 5s]
sky858: checks 
KAWABANGADU06: bets $0.02
panpaniscus1: calls $0.02
sky858: folds 
*** TURN *** [9s 2c 5s] [7d]
KAWABANGADU06: bets $0.02
panpaniscus1: calls $0.02
*** RIVER *** [9s 2c 5s 7d] [7h]
KAWABANGADU06: bets $0.02
panpaniscus1: calls $0.02
*** SHOW DOWN ***
KAWABANGADU06: shows [2h Th] (two pair, Sevens and Deuces)
panpaniscus1: shows [3c 3s] (two pair, Sevens and Threes)
panpaniscus1 collected $0.31 from pot
*** SUMMARY ***
Total pot $0.32 | Rake $0.01 
Board [9s 2c 5s 7d 7h]
Seat 1: sky858 (small blind) folded on the Flop
Seat 2: Sonyland (big blind) folded before Flop
Seat 3: Lorpugo folded before Flop (didn't bet)
Seat 4: KAWABANGADU06 showed [2h Th] and lost with two pair, Sevens and Deuces
Seat 5: 303:808 folded before Flop (didn't bet)
Seat 6: panpaniscus1 (button) showed [3c 3s] and won ($0.31) with two pair, Sevens and Threes



PokerStars Hand #240776122167:  Hold'em No Limit ($0.01/$0.02 USD) - 2022/12/29 12:09:34 ET
Table 'Idelsonia II' 6-max Seat #1 is the button
Seat 1: sky858 ($2.05 in chips) 
Seat 2: Sonyland ($0.85 in chips) 
Seat 3: Lorpugo ($2.23 in chips) 
Seat 4: KAWABANGADU06 ($0.38 in chips) 
Seat 5: 303:808 ($2.03 in chips) 
Seat 6: panpaniscus1 ($2.19 in chips) 
Sonyland: posts small blind $0.01
Lorpugo: posts big blind $0.02
*** HOLE CARDS ***
Dealt to Lorpugo [8h 3h]
KAWABANGADU06: folds 
303:808: folds 
panpaniscus1: folds 
sky858: folds 
Sonyland: folds 
Uncalled bet ($0.01) returned to Lorpugo
Lorpugo collected $0.02 from pot
Lorpugo: doesn't show hand 
*** SUMMARY ***
Total pot $0.02 | Rake $0 
Seat 1: sky858 (button) folded before Flop (didn't bet)
Seat 2: Sonyland (small blind) folded before Flop
Seat 3: Lorpugo (big blind) collected ($0.02)
Seat 4: KAWABANGADU06 folded before Flop (didn't bet)
Seat 5: 303:808 folded before Flop (didn't bet)
Seat 6: panpaniscus1 folded before Flop (didn't bet)



PokerStars Hand #240776125082:  Hold'em No Limit ($0.01/$0.02 USD) - 2022/12/29 12:09:42 ET
Table 'Idelsonia II' 6-max Seat #2 is the button
Seat 1: sky858 ($2.05 in chips) 
Seat 2: Sonyland ($0.84 in chips) 
Seat 3: Lorpugo ($2.24 in chips) 
Seat 4: KAWABANGADU06 ($0.38 in chips) 
Seat 5: 303:808 ($2.03 in chips) 
Seat 6: panpaniscus1 ($2.19 in chips) 
Lorpugo: posts small blind $0.01
KAWABANGADU06: posts big blind $0.02
*** HOLE CARDS ***
Dealt to Lorpugo [Kd 5c]
303:808: folds 
panpaniscus1: folds 
sky858: folds 
Sonyland: folds 
Lorpugo: raises $0.04 to $0.06
KAWABANGADU06: calls $0.04
*** FLOP *** [6s 9h Qh]
Lorpugo: checks 
KAWABANGADU06: checks 
*** TURN *** [6s 9h Qh] [4d]
Lorpugo: bets $0.02
KAWABANGADU06: calls $0.02
*** RIVER *** [6s 9h Qh 4d] [Ks]
Lorpugo: bets $0.44
KAWABANGADU06: calls $0.30 and is all-in
Uncalled bet ($0.14) returned to Lorpugo
*** SHOW DOWN ***
Lorpugo: shows [Kd 5c] (a pair of Kings)
KAWABANGADU06: shows [Tc Js] (a straight, Nine to King)
KAWABANGADU06 collected $0.73 from pot
*** SUMMARY ***
Total pot $0.76 | Rake $0.03 
Board [6s 9h Qh 4d Ks]
Seat 1: sky858 folded before Flop (didn't bet)
Seat 2: Sonyland (button) folded before Flop (didn't bet)
Seat 3: Lorpugo (small blind) showed [Kd 5c] and lost with a pair of Kings
Seat 4: KAWABANGADU06 (big blind) showed [Tc Js] and won ($0.73) with a straight, Nine to King
Seat 5: 303:808 folded before Flop (didn't bet)
Seat 6: panpaniscus1 folded before Flop (didn't bet)



PokerStars Hand #240776138257:  Hold'em No Limit ($0.01/$0.02 USD) - 2022/12/29 12:10:21 ET
Table 'Idelsonia II' 6-max Seat #3 is the button
Seat 1: sky858 ($2.05 in chips) 
Seat 2: Sonyland ($0.84 in chips) 
Seat 3: Lorpugo ($1.86 in chips) 
Seat 4: KAWABANGADU06 ($0.73 in chips) 
Seat 5: 303:808 ($2.03 in chips) 
Seat 6: panpaniscus1 ($2.19 in chips) 
KAWABANGADU06: posts small blind $0.01
303:808: posts big blind $0.02
*** HOLE CARDS ***
Dealt to Lorpugo [4d Qd]
panpaniscus1: folds 
sky858: folds 
Sonyland: raises $0.04 to $0.06
Lorpugo: folds 
KAWABANGADU06: folds 
303:808: folds 
Uncalled bet ($0.04) returned to Sonyland
Sonyland collected $0.05 from pot
Sonyland: doesn't show hand 
*** SUMMARY ***
Total pot $0.05 | Rake $0 
Seat 1: sky858 folded before Flop (didn't bet)
Seat 2: Sonyland collected ($0.05)
Seat 3: Lorpugo (button) folded before Flop (didn't bet)
Seat 4: KAWABANGADU06 (small blind) folded before Flop
Seat 5: 303:808 (big blind) folded before Flop
Seat 6: panpaniscus1 folded before Flop (didn't bet)



PokerStars Hand #240776146715:  Hold'em No Limit ($0.01/$0.02 USD) - 2022/12/29 12:10:46 ET
Table 'Idelsonia II' 6-max Seat #4 is the button
Seat 1: sky858 ($2.05 in chips) 
Seat 2: Sonyland ($0.87 in chips) 
Seat 3: Lorpugo ($1.86 in chips) 
Seat 4: KAWABANGADU06 ($0.72 in chips) 
Seat 5: 303:808 ($2.01 in chips) 
Seat 6: panpaniscus1 ($2.19 in chips) 
303:808: posts small blind $0.01
panpaniscus1: posts big blind $0.02
*** HOLE CARDS ***
Dealt to Lorpugo [4c As]
sky858: calls $0.02
Sonyland: folds 
Lorpugo: folds 
KAWABANGADU06: calls $0.02
303:808: folds 
panpaniscus1: checks 
*** FLOP *** [Qh Qc 9h]
panpaniscus1: checks 
sky858: checks 
KAWABANGADU06: bets $0.02
panpaniscus1: calls $0.02
sky858: folds 
*** TURN *** [Qh Qc 9h] [5h]
panpaniscus1: checks 
KAWABANGADU06: checks 
*** RIVER *** [Qh Qc 9h 5h] [Js]
panpaniscus1: checks 
KAWABANGADU06: checks 
*** SHOW DOWN ***
panpaniscus1: shows [8d Ts] (a straight, Eight to Queen)
KAWABANGADU06: mucks hand 
panpaniscus1 collected $0.11 from pot
*** SUMMARY ***
Total pot $0.11 | Rake $0 
Board [Qh Qc 9h 5h Js]
Seat 1: sky858 folded on the Flop
Seat 2: Sonyland folded before Flop (didn't bet)
Seat 3: Lorpugo folded before Flop (didn't bet)
Seat 4: KAWABANGADU06 (button) mucked [4h 4d]
Seat 5: 303:808 (small blind) folded before Flop
Seat 6: panpaniscus1 (big blind) showed [8d Ts] and won ($0.11) with a straight, Eight to Queen



PokerStars Hand #240776158243:  Hold'em No Limit ($0.01/$0.02 USD) - 2022/12/29 12:11:20 ET
Table 'Idelsonia II' 6-max Seat #5 is the button
Seat 1: sky858 ($2.03 in chips) 
Seat 2: Sonyland ($0.87 in chips) 
Seat 3: Lorpugo ($1.86 in chips) 
Seat 4: KAWABANGADU06 ($0.68 in chips) 
Seat 5: 303:808 ($2 in chips) 
Seat 6: panpaniscus1 ($2.26 in chips) 
panpaniscus1: posts small blind $0.01
sky858: posts big blind $0.02
*** HOLE CARDS ***
Dealt to Lorpugo [6h Qd]
Sonyland: folds 
Lorpugo: folds 
KAWABANGADU06: folds 
303:808: folds 
panpaniscus1: folds 
Uncalled bet ($0.01) returned to sky858
sky858 collected $0.02 from pot
sky858: doesn't show hand 
*** SUMMARY ***
Total pot $0.02 | Rake $0 
Seat 1: sky858 (big blind) collected ($0.02)
Seat 2: Sonyland folded before Flop (didn't bet)
Seat 3: Lorpugo folded before Flop (didn't bet)
Seat 4: KAWABANGADU06 folded before Flop (didn't bet)
Seat 5: 303:808 (button) folded before Flop (didn't bet)
Seat 6: panpaniscus1 (small blind) folded before Flop



PokerStars Hand #240776163022:  Hold'em No Limit ($0.01/$0.02 USD) - 2022/12/29 12:11:34 ET
Table 'Idelsonia II' 6-max Seat #6 is the button
Seat 1: sky858 ($2.04 in chips) 
Seat 2: Sonyland ($0.87 in chips) 
Seat 3: Lorpugo ($1.86 in chips) 
Seat 4: KAWABANGADU06 ($0.68 in chips) 
Seat 5: 303:808 ($2 in chips) 
Seat 6: panpaniscus1 ($2.25 in chips) 
sky858: posts small blind $0.01
Sonyland: posts big blind $0.02
*** HOLE CARDS ***
Dealt to Lorpugo [Jd 8c]
Lorpugo: folds 
KAWABANGADU06: folds 
303:808: folds 
panpaniscus1: raises $0.03 to $0.05
sky858: folds 
Sonyland: folds 
Uncalled bet ($0.03) returned to panpaniscus1
panpaniscus1 collected $0.05 from pot
panpaniscus1: doesn't show hand 
*** SUMMARY ***
Total pot $0.05 | Rake $0 
Seat 1: sky858 (small blind) folded before Flop
Seat 2: Sonyland (big blind) folded before Flop
Seat 3: Lorpugo folded before Flop (didn't bet)
Seat 4: KAWABANGADU06 folded before Flop (didn't bet)
Seat 5: 303:808 folded before Flop (didn't bet)
Seat 6: panpaniscus1 (button) collected ($0.05)



PokerStars Hand #240776169532:  Hold'em No Limit ($0.01/$0.02 USD) - 2022/12/29 12:11:53 ET
Table 'Idelsonia II' 6-max Seat #1 is the button
Seat 1: sky858 ($2.03 in chips) 
Seat 2: Sonyland ($0.85 in chips) 
Seat 3: Lorpugo ($1.86 in chips) 
Seat 4: KAWABANGADU06 ($0.68 in chips) 
Seat 5: 303:808 ($2 in chips) 
Seat 6: panpaniscus1 ($2.28 in chips) 
Sonyland: posts small blind $0.01
Lorpugo: posts big blind $0.02
*** HOLE CARDS ***
Dealt to Lorpugo [6d Ah]
KAWABANGADU06: folds 
303:808: raises $0.03 to $0.05
panpaniscus1: calls $0.05
sky858: folds 
Sonyland: raises $0.15 to $0.20
Lorpugo: folds 
303:808: raises $1.80 to $2 and is all-in
panpaniscus1: folds 
Sonyland: calls $0.65 and is all-in
Uncalled bet ($1.15) returned to 303:808
*** FLOP *** [6s Ad 5s]
*** TURN *** [6s Ad 5s] [Td]
*** RIVER *** [6s Ad 5s Td] [Tc]
*** SHOW DOWN ***
Sonyland: shows [Jh Js] (two pair, Jacks and Tens)
303:808: shows [Kh Ac] (two pair, Aces and Tens)
303:808 collected $1.71 from pot
Sonyland cashed out the hand for $0.97 | Cash Out Fee $0.01
*** SUMMARY ***
Total pot $1.77 | Rake $0.06 
Board [6s Ad 5s Td Tc]
Seat 1: sky858 (button) folded before Flop (didn't bet)
Seat 2: Sonyland (small blind) showed [Jh Js] and lost with two pair, Jacks and Tens (cashed out).
Seat 3: Lorpugo (big blind) folded before Flop
Seat 4: KAWABANGADU06 folded before Flop (didn't bet)
Seat 5: 303:808 showed [Kh Ac] and won ($1.71) with two pair, Aces and Tens
Seat 6: panpaniscus1 folded before Flop



PokerStars Hand #240776184088:  Hold'em No Limit ($0.01/$0.02 USD) - 2022/12/29 12:12:35 ET
Table 'Idelsonia II' 6-max Seat #2 is the button
Seat 1: sky858 ($2.03 in chips) 
Seat 2: Sonyland ($0.97 in chips) 
Seat 3: Lorpugo ($1.84 in chips) 
Seat 4: KAWABANGADU06 ($0.68 in chips) 
Seat 5: 303:808 ($2.86 in chips) 
Seat 6: panpaniscus1 ($2.23 in chips) 
Lorpugo: posts small blind $0.01
KAWABANGADU06: posts big blind $0.02
*** HOLE CARDS ***
Dealt to Lorpugo [5d 2h]
303:808: folds 
panpaniscus1: raises $0.03 to $0.05
sky858: folds 
Sonyland: folds 
Lorpugo: folds 
KAWABANGADU06: calls $0.03
*** FLOP *** [Qh Ac 8d]
KAWABANGADU06: checks 
panpaniscus1: bets $0.06
KAWABANGADU06: folds [As]
Uncalled bet ($0.06) returned to panpaniscus1
panpaniscus1 collected $0.11 from pot
panpaniscus1: doesn't show hand 
*** SUMMARY ***
Total pot $0.11 | Rake $0 
Board [Qh Ac 8d]
Seat 1: sky858 folded before Flop (didn't bet)
Seat 2: Sonyland (button) folded before Flop (didn't bet)
Seat 3: Lorpugo (small blind) folded before Flop
Seat 4: KAWABANGADU06 (big blind) folded on the Flop
Seat 5: 303:808 folded before Flop (didn't bet)
Seat 6: panpaniscus1 collected ($0.11)



PokerStars Hand #240776195121:  Hold'em No Limit ($0.01/$0.02 USD) - 2022/12/29 12:13:08 ET
Table 'Idelsonia II' 6-max Seat #3 is the button
Seat 1: sky858 ($2.03 in chips) 
Seat 2: Sonyland ($0.97 in chips) 
Seat 3: Lorpugo ($1.83 in chips) 
Seat 4: KAWABANGADU06 ($0.63 in chips) 
Seat 5: 303:808 ($2.86 in chips) 
Seat 6: panpaniscus1 ($2.29 in chips) 
KAWABANGADU06: posts small blind $0.01
303:808: posts big blind $0.02
*** HOLE CARDS ***
Dealt to Lorpugo [Ah 2d]
panpaniscus1: folds 
sky858: folds 
Sonyland: folds 
Lorpugo: raises $0.04 to $0.06
KAWABANGADU06: calls $0.05
303:808: calls $0.04
*** FLOP *** [Kc 8d 9d]
KAWABANGADU06: checks 
303:808: checks 
Lorpugo: checks 
*** TURN *** [Kc 8d 9d] [8c]
KAWABANGADU06: bets $0.02
303:808: calls $0.02
Lorpugo: folds 
*** RIVER *** [Kc 8d 9d 8c] [7d]
KAWABANGADU06: bets $0.02
303:808: calls $0.02
*** SHOW DOWN ***
KAWABANGADU06: shows [7s Ts] (two pair, Eights and Sevens)
303:808: shows [3d 4d] (a flush, Nine high)
303:808 collected $0.25 from pot
*** SUMMARY ***
Total pot $0.26 | Rake $0.01 
Board [Kc 8d 9d 8c 7d]
Seat 1: sky858 folded before Flop (didn't bet)
Seat 2: Sonyland folded before Flop (didn't bet)
Seat 3: Lorpugo (button) folded on the Turn
Seat 4: KAWABANGADU06 (small blind) showed [7s Ts] and lost with two pair, Eights and Sevens
Seat 5: 303:808 (big blind) showed [3d 4d] and won ($0.25) with a flush, Nine high
Seat 6: panpaniscus1 folded before Flop (didn't bet)



PokerStars Hand #240776206937:  Hold'em No Limit ($0.01/$0.02 USD) - 2022/12/29 12:13:43 ET
Table 'Idelsonia II' 6-max Seat #4 is the button
Seat 1: sky858 ($2.03 in chips) 
Seat 2: Sonyland ($0.97 in chips) 
Seat 3: Lorpugo ($1.77 in chips) 
Seat 4: KAWABANGADU06 ($0.53 in chips) 
Seat 5: 303:808 ($3.01 in chips) 
Seat 6: panpaniscus1 ($2.29 in chips) 
303:808: posts small blind $0.01
panpaniscus1: posts big blind $0.02
*** HOLE CARDS ***
Dealt to Lorpugo [Qc 5h]
sky858: folds 
Sonyland: folds 
Lorpugo: folds 
KAWABANGADU06: calls $0.02
303:808: folds 
panpaniscus1: raises $0.04 to $0.06
KAWABANGADU06: calls $0.04
*** FLOP *** [3c 4d 2h]
panpaniscus1: bets $0.08
KAWABANGADU06: calls $0.08
*** TURN *** [3c 4d 2h] [Jc]
panpaniscus1: checks 
KAWABANGADU06: bets $0.02
panpaniscus1: calls $0.02
*** RIVER *** [3c 4d 2h Jc] [Kh]
panpaniscus1: bets $0.10
KAWABANGADU06: raises $0.27 to $0.37 and is all-in
panpaniscus1: calls $0.27
*** SHOW DOWN ***
KAWABANGADU06: shows [5c 6h] (a straight, Deuce to Six)
panpaniscus1: shows [Ks Ah] (a pair of Kings)
KAWABANGADU06 collected $1.03 from pot
*** SUMMARY ***
Total pot $1.07 | Rake $0.04 
Board [3c 4d 2h Jc Kh]
Seat 1: sky858 folded before Flop (didn't bet)
Seat 2: Sonyland folded before Flop (didn't bet)
Seat 3: Lorpugo folded before Flop (didn't bet)
Seat 4: KAWABANGADU06 (button) showed [5c 6h] and won ($1.03) with a straight, Deuce to Six
Seat 5: 303:808 (small blind) folded before Flop
Seat 6: panpaniscus1 (big blind) showed [Ks Ah] and lost with a pair of Kings



PokerStars Hand #240776226593:  Hold'em No Limit ($0.01/$0.02 USD) - 2022/12/29 12:14:41 ET
Table 'Idelsonia II' 6-max Seat #5 is the button
Seat 1: sky858 ($2.03 in chips) 
Seat 2: Sonyland ($0.97 in chips) 
Seat 3: Lorpugo ($1.77 in chips) 
Seat 4: KAWABANGADU06 ($1.03 in chips) 
Seat 5: 303:808 ($3 in chips) 
Seat 6: panpaniscus1 ($1.76 in chips) 
panpaniscus1: posts small blind $0.01
sky858: posts big blind $0.02
*** HOLE CARDS ***
Dealt to Lorpugo [As 6h]
Sonyland: folds 
Lorpugo: folds 
KAWABANGADU06: calls $0.02
303:808: calls $0.02
panpaniscus1: folds 
sky858: checks 
*** FLOP *** [2h 9d Ad]
sky858: checks 
KAWABANGADU06: checks 
303:808: checks 
*** TURN *** [2h 9d Ad] [Ts]
sky858: checks 
KAWABANGADU06: checks 
303:808: checks 
*** RIVER *** [2h 9d Ad Ts] [8h]
sky858: checks 
KAWABANGADU06: bets $0.02
303:808: calls $0.02
sky858: folds 
*** SHOW DOWN ***
KAWABANGADU06: shows [8s Ks] (a pair of Eights)
303:808: shows [5c Ac] (a pair of Aces)
303:808 collected $0.11 from pot
*** SUMMARY ***
Total pot $0.11 | Rake $0 
Board [2h 9d Ad Ts 8h]
Seat 1: sky858 (big blind) folded on the River
Seat 2: Sonyland folded before Flop (didn't bet)
Seat 3: Lorpugo folded before Flop (didn't bet)
Seat 4: KAWABANGADU06 showed [8s Ks] and lost with a pair of Eights
Seat 5: 303:808 (button) showed [5c Ac] and won ($0.11) with a pair of Aces
Seat 6: panpaniscus1 (small blind) folded before Flop



PokerStars Hand #240776242292:  Hold'em No Limit ($0.01/$0.02 USD) - 2022/12/29 12:15:27 ET
Table 'Idelsonia II' 6-max Seat #6 is the button
Seat 1: sky858 ($2.01 in chips) 
Seat 2: Sonyland ($0.97 in chips) 
Seat 3: Lorpugo ($1.77 in chips) 
Seat 4: KAWABANGADU06 ($0.99 in chips) 
Seat 5: 303:808 ($3.07 in chips) 
Seat 6: panpaniscus1 ($2 in chips) 
sky858: posts small blind $0.01
Sonyland: posts big blind $0.02
*** HOLE CARDS ***
Dealt to Lorpugo [7h Ah]
Lorpugo: raises $0.04 to $0.06
KAWABANGADU06: folds 
303:808: folds 
panpaniscus1: folds 
sky858: folds 
Sonyland: folds 
Uncalled bet ($0.04) returned to Lorpugo
Lorpugo collected $0.05 from pot
Lorpugo: doesn't show hand 
*** SUMMARY ***
Total pot $0.05 | Rake $0 
Seat 1: sky858 (small blind) folded before Flop
Seat 2: Sonyland (big blind) folded before Flop
Seat 3: Lorpugo collected ($0.05)
Seat 4: KAWABANGADU06 folded before Flop (didn't bet)
Seat 5: 303:808 folded before Flop (didn't bet)
Seat 6: panpaniscus1 (button) folded before Flop (didn't bet)



PokerStars Hand #240776250669:  Hold'em No Limit ($0.01/$0.02 USD) - 2022/12/29 12:15:52 ET
Table 'Idelsonia II' 6-max Seat #1 is the button
Seat 1: sky858 ($2 in chips) 
Seat 2: Sonyland ($0.95 in chips) 
Seat 3: Lorpugo ($1.80 in chips) 
Seat 4: KAWABANGADU06 ($0.99 in chips) 
Seat 5: 303:808 ($3.07 in chips) 
Seat 6: panpaniscus1 ($2 in chips) 
Sonyland: posts small blind $0.01
Lorpugo: posts big blind $0.02
*** HOLE CARDS ***
Dealt to Lorpugo [6d 2d]
KAWABANGADU06: raises $0.06 to $0.08
303:808: folds 
panpaniscus1: calls $0.08
sky858: folds 
Sonyland: folds 
Lorpugo: folds 
*** FLOP *** [9h 7s 4d]
KAWABANGADU06: checks 
panpaniscus1: checks 
*** TURN *** [9h 7s 4d] [2h]
KAWABANGADU06: bets $0.02
panpaniscus1: calls $0.02
*** RIVER *** [9h 7s 4d 2h] [5s]
KAWABANGADU06: checks 
panpaniscus1: bets $0.07
KAWABANGADU06: folds 
Uncalled bet ($0.07) returned to panpaniscus1
panpaniscus1 collected $0.22 from pot
panpaniscus1: doesn't show hand 
*** SUMMARY ***
Total pot $0.23 | Rake $0.01 
Board [9h 7s 4d 2h 5s]
Seat 1: sky858 (button) folded before Flop (didn't bet)
Seat 2: Sonyland (small blind) folded before Flop
Seat 3: Lorpugo (big blind) folded before Flop
Seat 4: KAWABANGADU06 folded on the River
Seat 5: 303:808 folded before Flop (didn't bet)
Seat 6: panpaniscus1 collected ($0.22)



PokerStars Hand #240776263811:  Hold'em No Limit ($0.01/$0.02 USD) - 2022/12/29 12:16:30 ET
Table 'Idelsonia II' 6-max Seat #2 is the button
Seat 1: sky858 ($2 in chips) 
Seat 2: Sonyland ($0.94 in chips) 
Seat 3: Lorpugo ($1.78 in chips) 
Seat 4: KAWABANGADU06 ($0.89 in chips) 
Seat 5: 303:808 ($3.07 in chips) 
Seat 6: panpaniscus1 ($2.12 in chips) 
Lorpugo: posts small blind $0.01
KAWABANGADU06: posts big blind $0.02
*** HOLE CARDS ***
Dealt to Lorpugo [Ad 2c]
303:808: folds 
panpaniscus1: folds 
sky858: folds 
Sonyland: raises $0.04 to $0.06
Lorpugo: raises $0.14 to $0.20
KAWABANGADU06: folds 
Sonyland: calls $0.14
*** FLOP *** [4c Qd 7c]
Lorpugo: bets $1.58 and is all-in
Sonyland: calls $0.74 and is all-in
Uncalled bet ($0.84) returned to Lorpugo
*** TURN *** [4c Qd 7c] [Ts]
*** RIVER *** [4c Qd 7c Ts] [Js]
*** SHOW DOWN ***
Lorpugo: shows [Ad 2c] (high card Ace)
Sonyland: shows [8s 8h] (a pair of Eights)
Sonyland cashed out the hand for $1.48 | Cash Out Fee $0.02
*** SUMMARY ***
Total pot $1.90 | Rake $0.07 
Board [4c Qd 7c Ts Js]
Seat 1: sky858 folded before Flop (didn't bet)
Seat 2: Sonyland (button) showed [8s 8h] and won ($1.83) with a pair of Eights (pot not awarded as player cashed out)
Seat 3: Lorpugo (small blind) showed [Ad 2c] and lost with high card Ace
Seat 4: KAWABANGADU06 (big blind) folded before Flop
Seat 5: 303:808 folded before Flop (didn't bet)
Seat 6: panpaniscus1 folded before Flop (didn't bet)



PokerStars Hand #240776284094:  Hold'em No Limit ($0.01/$0.02 USD) - 2022/12/29 12:17:29 ET
Table 'Idelsonia II' 6-max Seat #3 is the button
Seat 1: sky858 ($2 in chips) 
Seat 2: Sonyland ($1.48 in chips) 
Seat 3: Lorpugo ($0.84 in chips) 
Seat 4: KAWABANGADU06 ($0.87 in chips) 
Seat 5: 303:808 ($3.07 in chips) 
Seat 6: panpaniscus1 ($2.12 in chips) 
KAWABANGADU06: posts small blind $0.01
303:808: posts big blind $0.02
*** HOLE CARDS ***
Dealt to Lorpugo [Qd 4h]
panpaniscus1: folds 
sky858: calls $0.02
Sonyland: folds 
Lorpugo: folds 
KAWABANGADU06: calls $0.01
303:808: checks 
*** FLOP *** [6c 2d 3s]
KAWABANGADU06: checks 
303:808: checks 
sky858: checks 
*** TURN *** [6c 2d 3s] [9d]
KAWABANGADU06: bets $0.02
Sonyland leaves the table
303:808: calls $0.02
sky858: folds 
*** RIVER *** [6c 2d 3s 9d] [7h]
KAWABANGADU06: bets $0.04
303:808: calls $0.04
*** SHOW DOWN ***
KAWABANGADU06: shows [9c Tc] (a pair of Nines)
303:808: mucks hand 
KAWABANGADU06 collected $0.17 from pot
*** SUMMARY ***
Total pot $0.18 | Rake $0.01 
Board [6c 2d 3s 9d 7h]
Seat 1: sky858 folded on the Turn
Seat 2: Sonyland folded before Flop (didn't bet)
Seat 3: Lorpugo (button) folded before Flop (didn't bet)
Seat 4: KAWABANGADU06 (small blind) showed [9c Tc] and won ($0.17) with a pair of Nines
Seat 5: 303:808 (big blind) mucked [7s 8c]
Seat 6: panpaniscus1 folded before Flop (didn't bet)



PokerStars Hand #240776297055:  Hold'em No Limit ($0.01/$0.02 USD) - 2022/12/29 12:18:07 ET
Table 'Idelsonia II' 6-max Seat #4 is the button
Seat 1: sky858 ($2 in chips) 
Seat 3: Lorpugo ($1.64 in chips) 
Seat 4: KAWABANGADU06 ($0.96 in chips) 
Seat 5: 303:808 ($2.99 in chips) 
Seat 6: panpaniscus1 ($2.12 in chips) 
303:808: posts small blind $0.01
panpaniscus1: posts big blind $0.02
*** HOLE CARDS ***
Dealt to Lorpugo [Jh Kc]
sky858: folds 
Lorpugo: raises $0.04 to $0.06
KAWABANGADU06: folds 
303:808: folds 
panpaniscus1: folds 
Uncalled bet ($0.04) returned to Lorpugo
Lorpugo collected $0.05 from pot
Lorpugo: doesn't show hand 
*** SUMMARY ***
Total pot $0.05 | Rake $0 
Seat 1: sky858 folded before Flop (didn't bet)
Seat 3: Lorpugo collected ($0.05)
Seat 4: KAWABANGADU06 (button) folded before Flop (didn't bet)
Seat 5: 303:808 (small blind) folded before Flop
Seat 6: panpaniscus1 (big blind) folded before Flop



PokerStars Hand #240776300353:  Hold'em No Limit ($0.01/$0.02 USD) - 2022/12/29 12:18:17 ET
Table 'Idelsonia II' 6-max Seat #5 is the button
Seat 1: sky858 ($2 in chips) 
Seat 3: Lorpugo ($1.67 in chips) 
Seat 4: KAWABANGADU06 ($0.96 in chips) 
Seat 5: 303:808 ($2.98 in chips) 
Seat 6: panpaniscus1 ($2.10 in chips) 
panpaniscus1: posts small blind $0.01
sky858: posts big blind $0.02
*** HOLE CARDS ***
Dealt to Lorpugo [8c 4s]
Lorpugo: folds 
KAWABANGADU06: folds 
303:808: raises $0.03 to $0.05
Manu_Sbg joins the table at seat #2 
panpaniscus1: folds 
sky858: folds 
Uncalled bet ($0.03) returned to 303:808
303:808 collected $0.05 from pot
303:808: doesn't show hand 
*** SUMMARY ***
Total pot $0.05 | Rake $0 
Seat 1: sky858 (big blind) folded before Flop
Seat 3: Lorpugo folded before Flop (didn't bet)
Seat 4: KAWABANGADU06 folded before Flop (didn't bet)
Seat 5: 303:808 (button) collected ($0.05)
Seat 6: panpaniscus1 (small blind) folded before Flop



PokerStars Hand #240776305078:  Hold'em No Limit ($0.01/$0.02 USD) - 2022/12/29 12:18:31 ET
Table 'Idelsonia II' 6-max Seat #6 is the button
Seat 1: sky858 ($2 in chips) 
Seat 2: Manu_Sbg ($2 in chips) 
Seat 3: Lorpugo ($1.67 in chips) 
Seat 4: KAWABANGADU06 ($0.96 in chips) 
Seat 5: 303:808 ($3.01 in chips) 
Seat 6: panpaniscus1 ($2.09 in chips) 
sky858: posts small blind $0.01
Manu_Sbg: posts big blind $0.02
*** HOLE CARDS ***
Dealt to Lorpugo [2d Ts]
Lorpugo: folds 
KAWABANGADU06: folds 
303:808: folds 
panpaniscus1: folds 
sky858: calls $0.01
Manu_Sbg: raises $0.04 to $0.06
sky858: calls $0.04
*** FLOP *** [7s 3d 8c]
sky858: checks 
Manu_Sbg: checks 
*** TURN *** [7s 3d 8c] [5h]
sky858: checks 
Manu_Sbg: checks 
*** RIVER *** [7s 3d 8c 5h] [2c]
sky858: checks 
Manu_Sbg: checks 
*** SHOW DOWN ***
sky858: shows [Ad 6d] (high card Ace)
Manu_Sbg: shows [Tc Ac] (high card Ace - Ten kicker)
Manu_Sbg collected $0.12 from pot
*** SUMMARY ***
Total pot $0.12 | Rake $0 
Board [7s 3d 8c 5h 2c]
Seat 1: sky858 (small blind) showed [Ad 6d] and lost with high card Ace
Seat 2: Manu_Sbg (big blind) showed [Tc Ac] and won ($0.12) with high card Ace
Seat 3: Lorpugo folded before Flop (didn't bet)
Seat 4: KAWABANGADU06 folded before Flop (didn't bet)
Seat 5: 303:808 folded before Flop (didn't bet)
Seat 6: panpaniscus1 (button) folded before Flop (didn't bet)



PokerStars Hand #240776315376:  Hold'em No Limit ($0.01/$0.02 USD) - 2022/12/29 12:19:00 ET
Table 'Idelsonia II' 6-max Seat #1 is the button
Seat 1: sky858 ($2 in chips) 
Seat 2: Manu_Sbg ($2.06 in chips) 
Seat 3: Lorpugo ($1.67 in chips) 
Seat 4: KAWABANGADU06 ($0.96 in chips) 
Seat 5: 303:808 ($3.01 in chips) 
Seat 6: panpaniscus1 ($2.09 in chips) 
Manu_Sbg: posts small blind $0.01
Lorpugo: posts big blind $0.02
*** HOLE CARDS ***
Dealt to Lorpugo [9h 6c]
KAWABANGADU06: folds 
303:808: folds 
panpaniscus1: folds 
sky858: folds 
Manu_Sbg: folds 
Uncalled bet ($0.01) returned to Lorpugo
Lorpugo collected $0.02 from pot
Lorpugo: doesn't show hand 
*** SUMMARY ***
Total pot $0.02 | Rake $0 
Seat 1: sky858 (button) folded before Flop (didn't bet)
Seat 2: Manu_Sbg (small blind) folded before Flop
Seat 3: Lorpugo (big blind) collected ($0.02)
Seat 4: KAWABANGADU06 folded before Flop (didn't bet)
Seat 5: 303:808 folded before Flop (didn't bet)
Seat 6: panpaniscus1 folded before Flop (didn't bet)



PokerStars Hand #240776319092:  Hold'em No Limit ($0.01/$0.02 USD) - 2022/12/29 12:19:11 ET
Table 'Idelsonia II' 6-max Seat #2 is the button
Seat 1: sky858 ($2 in chips) 
Seat 2: Manu_Sbg ($2.05 in chips) 
Seat 3: Lorpugo ($1.68 in chips) 
Seat 4: KAWABANGADU06 ($0.96 in chips) 
Seat 5: 303:808 ($3.01 in chips) 
Seat 6: panpaniscus1 ($2.09 in chips) 
Lorpugo: posts small blind $0.01
KAWABANGADU06: posts big blind $0.02
*** HOLE CARDS ***
Dealt to Lorpugo [5h Kd]
303:808: folds 
panpaniscus1: folds 
sky858: folds 
Manu_Sbg: folds 
Lorpugo: raises $0.04 to $0.06
KAWABANGADU06: calls $0.04
*** FLOP *** [Ad 3c Qd]
Lorpugo: bets $0.04
KAWABANGADU06: folds 
Uncalled bet ($0.04) returned to Lorpugo
Lorpugo collected $0.12 from pot
Lorpugo: doesn't show hand 
*** SUMMARY ***
Total pot $0.12 | Rake $0 
Board [Ad 3c Qd]
Seat 1: sky858 folded before Flop (didn't bet)
Seat 2: Manu_Sbg (button) folded before Flop (didn't bet)
Seat 3: Lorpugo (small blind) collected ($0.12)
Seat 4: KAWABANGADU06 (big blind) folded on the Flop
Seat 5: 303:808 folded before Flop (didn't bet)
Seat 6: panpaniscus1 folded before Flop (didn't bet)



PokerStars Hand #240776328030:  Hold'em No Limit ($0.01/$0.02 USD) - 2022/12/29 12:19:37 ET
Table 'Idelsonia II' 6-max Seat #3 is the button
Seat 1: sky858 ($2 in chips) 
Seat 2: Manu_Sbg ($2.05 in chips) 
Seat 3: Lorpugo ($1.74 in chips) 
Seat 4: KAWABANGADU06 ($0.90 in chips) 
Seat 5: 303:808 ($3.01 in chips) 
Seat 6: panpaniscus1 ($2.09 in chips) 
KAWABANGADU06: posts small blind $0.01
303:808: posts big blind $0.02
*** HOLE CARDS ***
Dealt to Lorpugo [7s 3h]
panpaniscus1: folds 
sky858: folds 
Manu_Sbg: folds 
Lorpugo: folds 
KAWABANGADU06: raises $0.02 to $0.04
303:808: calls $0.02
*** FLOP *** [8d 8s 3s]
KAWABANGADU06: bets $0.04
303:808: folds 
Uncalled bet ($0.04) returned to KAWABANGADU06
KAWABANGADU06 collected $0.08 from pot
*** SUMMARY ***
Total pot $0.08 | Rake $0 
Board [8d 8s 3s]
Seat 1: sky858 folded before Flop (didn't bet)
Seat 2: Manu_Sbg folded before Flop (didn't bet)
Seat 3: Lorpugo (button) folded before Flop (didn't bet)
Seat 4: KAWABANGADU06 (small blind) collected ($0.08)
Seat 5: 303:808 (big blind) folded on the Flop
Seat 6: panpaniscus1 folded before Flop (didn't bet)



PokerStars Hand #240776336749:  Hold'em No Limit ($0.01/$0.02 USD) - 2022/12/29 12:20:03 ET
Table 'Idelsonia II' 6-max Seat #4 is the button
Seat 1: sky858 ($2 in chips) 
Seat 2: Manu_Sbg ($2.05 in chips) 
Seat 3: Lorpugo ($1.74 in chips) 
Seat 4: KAWABANGADU06 ($0.94 in chips) 
Seat 5: 303:808 ($2.97 in chips) 
Seat 6: panpaniscus1 ($2.09 in chips) 
303:808: posts small blind $0.01
panpaniscus1: posts big blind $0.02
*** HOLE CARDS ***
Dealt to Lorpugo [9s Qd]
sky858: folds 
Manu_Sbg: raises $0.02 to $0.04
Lorpugo: folds 
KAWABANGADU06: raises $0.08 to $0.12
303:808: folds 
panpaniscus1: folds 
Manu_Sbg: calls $0.08
*** FLOP *** [8s 4c Kd]
Manu_Sbg: checks 
KAWABANGADU06: checks 
*** TURN *** [8s 4c Kd] [Ah]
Manu_Sbg: checks 
KAWABANGADU06: bets $0.02
Manu_Sbg: calls $0.02
*** RIVER *** [8s 4c Kd Ah] [2s]
Manu_Sbg: checks 
KAWABANGADU06: bets $0.40
Manu_Sbg: folds 
Uncalled bet ($0.40) returned to KAWABANGADU06
KAWABANGADU06 collected $0.30 from pot
*** SUMMARY ***
Total pot $0.31 | Rake $0.01 
Board [8s 4c Kd Ah 2s]
Seat 1: sky858 folded before Flop (didn't bet)
Seat 2: Manu_Sbg folded on the River
Seat 3: Lorpugo folded before Flop (didn't bet)
Seat 4: KAWABANGADU06 (button) collected ($0.30)
Seat 5: 303:808 (small blind) folded before Flop
Seat 6: panpaniscus1 (big blind) folded before Flop



PokerStars Hand #240776349754:  Hold'em No Limit ($0.01/$0.02 USD) - 2022/12/29 12:20:41 ET
Table 'Idelsonia II' 6-max Seat #5 is the button
Seat 1: sky858 ($2 in chips) 
Seat 2: Manu_Sbg ($2 in chips) 
Seat 3: Lorpugo ($1.74 in chips) 
Seat 4: KAWABANGADU06 ($1.10 in chips) 
Seat 5: 303:808 ($2.96 in chips) 
Seat 6: panpaniscus1 ($2.07 in chips) 
panpaniscus1: posts small blind $0.01
sky858: posts big blind $0.02
*** HOLE CARDS ***
Dealt to Lorpugo [6s 9s]
Manu_Sbg: folds 
Lorpugo: folds 
KAWABANGADU06: folds 
303:808: folds 
panpaniscus1: raises $0.03 to $0.05
sky858: calls $0.03
*** FLOP *** [2c Qc 7c]
panpaniscus1: checks 
sky858: checks 
*** TURN *** [2c Qc 7c] [4d]
panpaniscus1: checks 
sky858: checks 
*** RIVER *** [2c Qc 7c 4d] [9h]
panpaniscus1: checks 
sky858: checks 
*** SHOW DOWN ***
panpaniscus1: shows [Ts Ah] (high card Ace)
sky858: shows [4h As] (a pair of Fours)
sky858 collected $0.10 from pot
*** SUMMARY ***
Total pot $0.10 | Rake $0 
Board [2c Qc 7c 4d 9h]
Seat 1: sky858 (big blind) showed [4h As] and won ($0.10) with a pair of Fours
Seat 2: Manu_Sbg folded before Flop (didn't bet)
Seat 3: Lorpugo folded before Flop (didn't bet)
Seat 4: KAWABANGADU06 folded before Flop (didn't bet)
Seat 5: 303:808 (button) folded before Flop (didn't bet)
Seat 6: panpaniscus1 (small blind) showed [Ts Ah] and lost with high card Ace



PokerStars Hand #240776359749:  Hold'em No Limit ($0.01/$0.02 USD) - 2022/12/29 12:21:11 ET
Table 'Idelsonia II' 6-max Seat #6 is the button
Seat 1: sky858 ($2.05 in chips) 
Seat 2: Manu_Sbg ($2 in chips) 
Seat 3: Lorpugo ($1.74 in chips) 
Seat 4: KAWABANGADU06 ($1.10 in chips) 
Seat 5: 303:808 ($2.96 in chips) 
Seat 6: panpaniscus1 ($2.02 in chips) 
sky858: posts small blind $0.01
Manu_Sbg: posts big blind $0.02
*** HOLE CARDS ***
Dealt to Lorpugo [Jd Td]
Lorpugo: raises $0.04 to $0.06
KAWABANGADU06: folds 
303:808: folds 
panpaniscus1: calls $0.06
sky858: folds 
Manu_Sbg: calls $0.04
*** FLOP *** [8d 9c 2d]
Manu_Sbg: checks 
Lorpugo: bets $0.12
panpaniscus1: calls $0.12
Manu_Sbg: folds 
*** TURN *** [8d 9c 2d] [Kd]
Lorpugo: bets $0.21
panpaniscus1: folds 
Uncalled bet ($0.21) returned to Lorpugo
Lorpugo collected $0.41 from pot
Lorpugo: doesn't show hand 
*** SUMMARY ***
Total pot $0.43 | Rake $0.02 
Board [8d 9c 2d Kd]
Seat 1: sky858 (small blind) folded before Flop
Seat 2: Manu_Sbg (big blind) folded on the Flop
Seat 3: Lorpugo collected ($0.41)
Seat 4: KAWABANGADU06 folded before Flop (didn't bet)
Seat 5: 303:808 folded before Flop (didn't bet)
Seat 6: panpaniscus1 (button) folded on the Turn



PokerStars Hand #240776371964:  Hold'em No Limit ($0.01/$0.02 USD) - 2022/12/29 12:21:46 ET
Table 'Idelsonia II' 6-max Seat #1 is the button
Seat 1: sky858 ($2.04 in chips) 
Seat 2: Manu_Sbg ($2 in chips) 
Seat 3: Lorpugo ($1.97 in chips) 
Seat 4: KAWABANGADU06 ($1.10 in chips) 
Seat 5: 303:808 ($2.96 in chips) 
Seat 6: panpaniscus1 ($1.84 in chips) 
Manu_Sbg: posts small blind $0.01
Lorpugo: posts big blind $0.02
*** HOLE CARDS ***
Dealt to Lorpugo [Ks Ah]
KAWABANGADU06: calls $0.02
303:808: folds 
panpaniscus1: folds 
sky858: folds 
Manu_Sbg: raises $0.02 to $0.04
Lorpugo: raises $0.10 to $0.14
KAWABANGADU06: folds 
Manu_Sbg: folds 
Uncalled bet ($0.10) returned to Lorpugo
Lorpugo collected $0.10 from pot
Lorpugo: doesn't show hand 
*** SUMMARY ***
Total pot $0.10 | Rake $0 
Seat 1: sky858 (button) folded before Flop (didn't bet)
Seat 2: Manu_Sbg (small blind) folded before Flop
Seat 3: Lorpugo (big blind) collected ($0.10)
Seat 4: KAWABANGADU06 folded before Flop
Seat 5: 303:808 folded before Flop (didn't bet)
Seat 6: panpaniscus1 folded before Flop (didn't bet)



PokerStars Hand #240776378764:  Hold'em No Limit ($0.01/$0.02 USD) - 2022/12/29 12:22:06 ET
Table 'Idelsonia II' 6-max Seat #2 is the button
Seat 1: sky858 ($2.04 in chips) 
Seat 2: Manu_Sbg ($2 in chips) 
Seat 3: Lorpugo ($2.03 in chips) 
Seat 4: KAWABANGADU06 ($1.08 in chips) 
Seat 5: 303:808 ($2.96 in chips) 
Seat 6: panpaniscus1 ($1.84 in chips) 
Lorpugo: posts small blind $0.01
KAWABANGADU06: posts big blind $0.02
*** HOLE CARDS ***
Dealt to Lorpugo [7d Jd]
303:808: folds 
panpaniscus1: folds 
sky858: folds 
Manu_Sbg: folds 
Lorpugo: raises $0.04 to $0.06
KAWABANGADU06: calls $0.04
*** FLOP *** [Qs 4h Qd]
Lorpugo: bets $0.06
KAWABANGADU06: calls $0.06
*** TURN *** [Qs 4h Qd] [Qh]
Lorpugo: checks 
KAWABANGADU06: bets $0.02
Lorpugo: folds 
Uncalled bet ($0.02) returned to KAWABANGADU06
KAWABANGADU06 collected $0.23 from pot
*** SUMMARY ***
Total pot $0.24 | Rake $0.01 
Board [Qs 4h Qd Qh]
Seat 1: sky858 folded before Flop (didn't bet)
Seat 2: Manu_Sbg (button) folded before Flop (didn't bet)
Seat 3: Lorpugo (small blind) folded on the Turn
Seat 4: KAWABANGADU06 (big blind) collected ($0.23)
Seat 5: 303:808 folded before Flop (didn't bet)
Seat 6: panpaniscus1 folded before Flop (didn't bet)



PokerStars Hand #240776392684:  Hold'em No Limit ($0.01/$0.02 USD) - 2022/12/29 12:22:46 ET
Table 'Idelsonia II' 6-max Seat #3 is the button
Seat 1: sky858 ($2.04 in chips) 
Seat 2: Manu_Sbg ($2 in chips) 
Seat 3: Lorpugo ($1.91 in chips) 
Seat 4: KAWABANGADU06 ($1.19 in chips) 
Seat 5: 303:808 ($2.96 in chips) 
Seat 6: panpaniscus1 ($1.84 in chips) 
KAWABANGADU06: posts small blind $0.01
303:808: posts big blind $0.02
*** HOLE CARDS ***
Dealt to Lorpugo [5s 8h]
panpaniscus1: folds 
sky858: folds 
Manu_Sbg: folds 
Manu_Sbg leaves the table
Lorpugo: raises $0.04 to $0.06
KAWABANGADU06: calls $0.05
303:808: folds 
*** FLOP *** [2h 7c Ac]
KAWABANGADU06: checks 
Lorpugo: bets $0.07
KAWABANGADU06: calls $0.07
*** TURN *** [2h 7c Ac] [8s]
KAWABANGADU06: checks 
MPut8 joins the table at seat #2 
Lorpugo: bets $0.18
KAWABANGADU06: raises $0.88 to $1.06 and is all-in
Lorpugo: folds 
Uncalled bet ($0.88) returned to KAWABANGADU06
KAWABANGADU06 collected $0.62 from pot
*** SUMMARY ***
Total pot $0.64 | Rake $0.02 
Board [2h 7c Ac 8s]
Seat 1: sky858 folded before Flop (didn't bet)
Seat 2: Manu_Sbg folded before Flop (didn't bet)
Seat 3: Lorpugo (button) folded on the Turn
Seat 4: KAWABANGADU06 (small blind) collected ($0.62)
Seat 5: 303:808 (big blind) folded before Flop
Seat 6: panpaniscus1 folded before Flop (didn't bet)



PokerStars Hand #240776410459:  Hold'em No Limit ($0.01/$0.02 USD) - 2022/12/29 12:23:37 ET
Table 'Idelsonia II' 6-max Seat #4 is the button
Seat 1: sky858 ($2.04 in chips) 
Seat 2: MPut8 ($1.67 in chips) 
Seat 3: Lorpugo ($1.60 in chips) 
Seat 4: KAWABANGADU06 ($1.50 in chips) 
Seat 5: 303:808 ($2.94 in chips) 
Seat 6: panpaniscus1 ($1.84 in chips) 
303:808: posts small blind $0.01
panpaniscus1: posts big blind $0.02
MPut8: posts big blind $0.02
*** HOLE CARDS ***
Dealt to Lorpugo [9s 9h]
sky858: folds 
MPut8: checks 
Lorpugo: raises $0.07 to $0.09
KAWABANGADU06: folds 
303:808: folds 
panpaniscus1: folds 
MPut8: folds 
Uncalled bet ($0.07) returned to Lorpugo
Lorpugo collected $0.07 from pot
Lorpugo: doesn't show hand 
*** SUMMARY ***
Total pot $0.07 | Rake $0 
Seat 1: sky858 folded before Flop (didn't bet)
Seat 2: MPut8 folded before Flop (didn't bet)
Seat 3: Lorpugo collected ($0.07)
Seat 4: KAWABANGADU06 (button) folded before Flop (didn't bet)
Seat 5: 303:808 (small blind) folded before Flop
Seat 6: panpaniscus1 (big blind) folded before Flop



PokerStars Hand #240776419670:  Hold'em No Limit ($0.01/$0.02 USD) - 2022/12/29 12:24:04 ET
Table 'Idelsonia II' 6-max Seat #5 is the button
Seat 2: MPut8 ($1.65 in chips) 
Seat 3: Lorpugo ($1.65 in chips) 
Seat 4: KAWABANGADU06 ($1.50 in chips) 
Seat 5: 303:808 ($2.93 in chips) 
Seat 6: panpaniscus1 ($1.82 in chips) 
panpaniscus1: posts small blind $0.01
MPut8: posts big blind $0.02
*** HOLE CARDS ***
Dealt to Lorpugo [Qs Jd]
sky858 leaves the table
Lorpugo: raises $0.04 to $0.06
dsolmos joins the table at seat #1 
KAWABANGADU06: calls $0.06
303:808: folds 
panpaniscus1: folds 
MPut8: folds 
*** FLOP *** [Kh 9s 4c]
Lorpugo: bets $0.07
KAWABANGADU06: folds 
Uncalled bet ($0.07) returned to Lorpugo
Lorpugo collected $0.14 from pot
Lorpugo: doesn't show hand 
*** SUMMARY ***
Total pot $0.15 | Rake $0.01 
Board [Kh 9s 4c]
Seat 2: MPut8 (big blind) folded before Flop
Seat 3: Lorpugo collected ($0.14)
Seat 4: KAWABANGADU06 folded on the Flop
Seat 5: 303:808 (button) folded before Flop (didn't bet)
Seat 6: panpaniscus1 (small blind) folded before Flop



PokerStars Hand #240776427700:  Hold'em No Limit ($0.01/$0.02 USD) - 2022/12/29 12:24:27 ET
Table 'Idelsonia II' 6-max Seat #6 is the button
Seat 2: MPut8 ($1.63 in chips) 
Seat 3: Lorpugo ($1.73 in chips) 
Seat 4: KAWABANGADU06 ($1.44 in chips) 
Seat 5: 303:808 ($2.93 in chips) 
Seat 6: panpaniscus1 ($1.81 in chips) 
MPut8: posts small blind $0.01
Lorpugo: posts big blind $0.02
*** HOLE CARDS ***
Dealt to Lorpugo [As Tc]
KAWABANGADU06: folds 
303:808: folds 
panpaniscus1: raises $0.03 to $0.05
MPut8: folds 
Lorpugo: calls $0.03
*** FLOP *** [Ts 3h 5h]
Lorpugo: bets $0.07
panpaniscus1: calls $0.07
*** TURN *** [Ts 3h 5h] [4d]
Lorpugo: checks 
panpaniscus1: checks 
*** RIVER *** [Ts 3h 5h 4d] [6h]
Lorpugo: bets $0.32
panpaniscus1: folds 
Uncalled bet ($0.32) returned to Lorpugo
Lorpugo collected $0.24 from pot
Lorpugo: doesn't show hand 
*** SUMMARY ***
Total pot $0.25 | Rake $0.01 
Board [Ts 3h 5h 4d 6h]
Seat 2: MPut8 (small blind) folded before Flop
Seat 3: Lorpugo (big blind) collected ($0.24)
Seat 4: KAWABANGADU06 folded before Flop (didn't bet)
Seat 5: 303:808 folded before Flop (didn't bet)
Seat 6: panpaniscus1 (button) folded on the River



PokerStars Hand #240776459294:  Hold'em No Limit ($0.01/$0.02 USD) - 2022/12/29 12:25:56 ET
Table 'Idelsonia II' 6-max Seat #2 is the button
Seat 1: dsolmos ($2 in chips) 
Seat 2: MPut8 ($1.62 in chips) 
Seat 3: Lorpugo ($1.85 in chips) 
Seat 4: KAWABANGADU06 ($1.44 in chips) 
Seat 5: 303:808 ($2.93 in chips) 
Seat 6: panpaniscus1 ($1.69 in chips) 
Lorpugo: posts small blind $0.01
KAWABANGADU06: posts big blind $0.02
dsolmos: posts big blind $0.02
*** HOLE CARDS ***
Dealt to Lorpugo [Ad 9c]
303:808: folds 
panpaniscus1: raises $0.03 to $0.05
dsolmos: raises $0.09 to $0.14
MPut8: calls $0.14
Lorpugo: folds 
KAWABANGADU06: folds 
panpaniscus1: calls $0.09
*** FLOP *** [4c Jc 7s]
panpaniscus1: checks 
dsolmos: bets $0.16
MPut8: folds 
panpaniscus1: folds 
Uncalled bet ($0.16) returned to dsolmos
dsolmos collected $0.43 from pot
*** SUMMARY ***
Total pot $0.45 | Rake $0.02 
Board [4c Jc 7s]
Seat 1: dsolmos collected ($0.43)
Seat 2: MPut8 (button) folded on the Flop
Seat 3: Lorpugo (small blind) folded before Flop
Seat 4: KAWABANGADU06 (big blind) folded before Flop
Seat 5: 303:808 folded before Flop (didn't bet)
Seat 6: panpaniscus1 folded on the Flop



PokerStars Hand #240776477344:  Hold'em No Limit ($0.01/$0.02 USD) - 2022/12/29 12:26:46 ET
Table 'Idelsonia II' 6-max Seat #3 is the button
Seat 1: dsolmos ($2.29 in chips) 
Seat 2: MPut8 ($1.48 in chips) 
Seat 3: Lorpugo ($1.84 in chips) 
Seat 4: KAWABANGADU06 ($1.42 in chips) 
Seat 5: 303:808 ($2.93 in chips) 
Seat 6: panpaniscus1 ($1.55 in chips) 
KAWABANGADU06: posts small blind $0.01
303:808: posts big blind $0.02
*** HOLE CARDS ***
Dealt to Lorpugo [3d 2c]
panpaniscus1: folds 
dsolmos: folds 
MPut8: raises $0.05 to $0.07
Lorpugo: folds 
KAWABANGADU06: folds 
303:808: folds 
Uncalled bet ($0.05) returned to MPut8
303:808 leaves the table
MPut8 collected $0.05 from pot
*** SUMMARY ***
Total pot $0.05 | Rake $0 
Seat 1: dsolmos folded before Flop (didn't bet)
Seat 2: MPut8 collected ($0.05)
Seat 3: Lorpugo (button) folded before Flop (didn't bet)
Seat 4: KAWABANGADU06 (small blind) folded before Flop
Seat 5: 303:808 (big blind) folded before Flop
Seat 6: panpaniscus1 folded before Flop (didn't bet)



PokerStars Hand #240776482681:  Hold'em No Limit ($0.01/$0.02 USD) - 2022/12/29 12:27:01 ET
Table 'Idelsonia II' 6-max Seat #4 is the button
Seat 1: dsolmos ($2.29 in chips) 
Seat 2: MPut8 ($2 in chips) 
Seat 3: Lorpugo ($1.84 in chips) 
Seat 4: KAWABANGADU06 ($1.41 in chips) 
Seat 6: panpaniscus1 ($2 in chips) 
panpaniscus1: posts small blind $0.01
dsolmos: posts big blind $0.02
*** HOLE CARDS ***
Dealt to Lorpugo [2h 4d]
MPut8: folds 
Lorpugo: folds 
KAWABANGADU06: calls $0.02
panpaniscus1: folds 
dsolmos: checks 
*** FLOP *** [5d 5h Ts]
dsolmos: checks 
KAWABANGADU06: bets $0.04
el_rasslo joins the table at seat #5 
dsolmos: raises $0.07 to $0.11
KAWABANGADU06: folds [Th]
Uncalled bet ($0.07) returned to dsolmos
dsolmos collected $0.13 from pot
*** SUMMARY ***
Total pot $0.13 | Rake $0 
Board [5d 5h Ts]
Seat 1: dsolmos (big blind) collected ($0.13)
Seat 2: MPut8 folded before Flop (didn't bet)
Seat 3: Lorpugo folded before Flop (didn't bet)
Seat 4: KAWABANGADU06 (button) folded on the Flop
Seat 6: panpaniscus1 (small blind) folded before Flop



PokerStars Hand #240776498432:  Hold'em No Limit ($0.01/$0.02 USD) - 2022/12/29 12:27:44 ET
Table 'Idelsonia II' 6-max Seat #6 is the button
Seat 1: dsolmos ($2.36 in chips) 
Seat 2: MPut8 ($2 in chips) 
Seat 3: Lorpugo ($1.84 in chips) 
Seat 4: KAWABANGADU06 ($1.35 in chips) 
Seat 5: el_rasslo ($2 in chips) 
Seat 6: panpaniscus1 ($1.99 in chips) 
dsolmos: posts small blind $0.01
MPut8: posts big blind $0.02
el_rasslo: posts big blind $0.02
*** HOLE CARDS ***
Dealt to Lorpugo [4c 6h]
Lorpugo: folds 
KAWABANGADU06: raises $0.02 to $0.04
el_rasslo: calls $0.02
panpaniscus1: raises $0.06 to $0.10
dsolmos: folds 
MPut8: folds 
KAWABANGADU06: calls $0.06
el_rasslo: calls $0.06
*** FLOP *** [9h 9c Jc]
KAWABANGADU06: checks 
el_rasslo: checks 
panpaniscus1: checks 
*** TURN *** [9h 9c Jc] [2c]
KAWABANGADU06: checks 
el_rasslo: checks 
panpaniscus1: checks 
*** RIVER *** [9h 9c Jc 2c] [3h]
KAWABANGADU06: checks 
el_rasslo: checks 
panpaniscus1: checks 
*** SHOW DOWN ***
KAWABANGADU06: shows [Kh Qc] (a pair of Nines)
el_rasslo: shows [Kc 2s] (two pair, Nines and Deuces)
panpaniscus1: mucks hand 
el_rasslo collected $0.32 from pot
*** SUMMARY ***
Total pot $0.33 | Rake $0.01 
Board [9h 9c Jc 2c 3h]
Seat 1: dsolmos (small blind) folded before Flop
Seat 2: MPut8 (big blind) folded before Flop
Seat 3: Lorpugo folded before Flop (didn't bet)
Seat 4: KAWABANGADU06 showed [Kh Qc] and lost with a pair of Nines
Seat 5: el_rasslo showed [Kc 2s] and won ($0.32) with two pair, Nines and Deuces
Seat 6: panpaniscus1 (button) mucked [Ts Ac]



PokerStars Hand #240776518095:  Hold'em No Limit ($0.01/$0.02 USD) - 2022/12/29 12:28:39 ET
Table 'Idelsonia II' 6-max Seat #1 is the button
Seat 1: dsolmos ($2.35 in chips) 
Seat 2: MPut8 ($1.98 in chips) 
Seat 3: Lorpugo ($1.84 in chips) 
Seat 4: KAWABANGADU06 ($1.25 in chips) 
Seat 5: el_rasslo ($2.22 in chips) 
Seat 6: panpaniscus1 ($1.89 in chips) 
MPut8: posts small blind $0.01
Lorpugo: posts big blind $0.02
*** HOLE CARDS ***
Dealt to Lorpugo [Ah Kc]
KAWABANGADU06: folds 
el_rasslo: raises $0.02 to $0.04
panpaniscus1: folds 
dsolmos: folds 
MPut8: calls $0.03
Lorpugo: raises $0.12 to $0.16
el_rasslo: calls $0.12
MPut8: calls $0.12
*** FLOP *** [4c 8d Tc]
MPut8: checks 
Lorpugo: checks 
el_rasslo: bets $0.20
MPut8: calls $0.20
Lorpugo: folds 
*** TURN *** [4c 8d Tc] [Ks]
MPut8: checks 
el_rasslo: checks 
*** RIVER *** [4c 8d Tc Ks] [9h]
MPut8: checks 
el_rasslo: checks 
*** SHOW DOWN ***
MPut8: shows [5s 5d] (a pair of Fives)
el_rasslo: mucks hand 
MPut8 collected $0.85 from pot
*** SUMMARY ***
Total pot $0.88 | Rake $0.03 
Board [4c 8d Tc Ks 9h]
Seat 1: dsolmos (button) folded before Flop (didn't bet)
Seat 2: MPut8 (small blind) showed [5s 5d] and won ($0.85) with a pair of Fives
Seat 3: Lorpugo (big blind) folded on the Flop
Seat 4: KAWABANGADU06 folded before Flop (didn't bet)
Seat 5: el_rasslo mucked [As Qs]
Seat 6: panpaniscus1 folded before Flop (didn't bet)



PokerStars Hand #240776540907:  Hold'em No Limit ($0.01/$0.02 USD) - 2022/12/29 12:29:42 ET
Table 'Idelsonia II' 6-max Seat #2 is the button
Seat 1: dsolmos ($2.35 in chips) 
Seat 2: MPut8 ($2.47 in chips) 
Seat 3: Lorpugo ($1.68 in chips) 
Seat 4: KAWABANGADU06 ($1.25 in chips) 
Seat 5: el_rasslo ($1.86 in chips) 
Seat 6: panpaniscus1 ($1.89 in chips) 
Lorpugo: posts small blind $0.01
KAWABANGADU06: posts big blind $0.02
*** HOLE CARDS ***
Dealt to Lorpugo [Ah 2h]
el_rasslo: calls $0.02
panpaniscus1: folds 
panpaniscus1 leaves the table
dsolmos: folds 
MPut8: calls $0.02
Lorpugo: calls $0.01
KAWABANGADU06: checks 
*** FLOP *** [Js 7d 5h]
Lorpugo: checks 
KAWABANGADU06: checks 
el_rasslo: checks 
Andry00701 joins the table at seat #6 
MPut8: bets $0.04
Lorpugo: folds 
KAWABANGADU06: folds 
el_rasslo: calls $0.04
*** TURN *** [Js 7d 5h] [Jh]
el_rasslo: checks 
MPut8: bets $0.15
el_rasslo: folds 
Uncalled bet ($0.15) returned to MPut8
MPut8 collected $0.15 from pot
*** SUMMARY ***
Total pot $0.16 | Rake $0.01 
Board [Js 7d 5h Jh]
Seat 1: dsolmos folded before Flop (didn't bet)
Seat 2: MPut8 (button) collected ($0.15)
Seat 3: Lorpugo (small blind) folded on the Flop
Seat 4: KAWABANGADU06 (big blind) folded on the Flop
Seat 5: el_rasslo folded on the Turn
Seat 6: panpaniscus1 folded before Flop (didn't bet)



PokerStars Hand #240776560898:  Hold'em No Limit ($0.01/$0.02 USD) - 2022/12/29 12:30:35 ET
Table 'Idelsonia II' 6-max Seat #3 is the button
Seat 1: dsolmos ($2.35 in chips) 
Seat 2: MPut8 ($2.56 in chips) 
Seat 3: Lorpugo ($1.66 in chips) 
Seat 4: KAWABANGADU06 ($1.23 in chips) 
Seat 5: el_rasslo ($1.80 in chips) 
KAWABANGADU06: posts small blind $0.01
el_rasslo: posts big blind $0.02
*** HOLE CARDS ***
Dealt to Lorpugo [Ah 5d]
dsolmos: folds 
MPut8: raises $0.04 to $0.06
Lorpugo: calls $0.06
KAWABANGADU06: calls $0.05
el_rasslo: calls $0.04
*** FLOP *** [9d Js Tc]
KAWABANGADU06: checks 
el_rasslo: checks 
MPut8: checks 
Lorpugo: checks 
*** TURN *** [9d Js Tc] [Td]
KAWABANGADU06: checks 
el_rasslo: checks 
MPut8: checks 
Lorpugo: checks 
*** RIVER *** [9d Js Tc Td] [9c]
KAWABANGADU06: checks 
el_rasslo: bets $0.10
MPut8: folds 
Lorpugo: calls $0.10
KAWABANGADU06: folds 
*** SHOW DOWN ***
el_rasslo: shows [4h Th] (a full house, Tens full of Nines)
Lorpugo: mucks hand 
el_rasslo collected $0.42 from pot
*** SUMMARY ***
Total pot $0.44 | Rake $0.02 
Board [9d Js Tc Td 9c]
Seat 1: dsolmos folded before Flop (didn't bet)
Seat 2: MPut8 folded on the River
Seat 3: Lorpugo (button) mucked [Ah 5d]
Seat 4: KAWABANGADU06 (small blind) folded on the River
Seat 5: el_rasslo (big blind) showed [4h Th] and won ($0.42) with a full house, Tens full of Nines



PokerStars Hand #240776592174:  Hold'em No Limit ($0.01/$0.02 USD) - 2022/12/29 12:31:59 ET
Table 'Idelsonia II' 6-max Seat #4 is the button
Seat 1: dsolmos ($2.35 in chips) 
Seat 2: MPut8 ($2.50 in chips) 
Seat 3: Lorpugo ($1.50 in chips) 
Seat 4: KAWABANGADU06 ($1.17 in chips) 
Seat 5: el_rasslo ($2.06 in chips) 
Seat 6: Andry00701 ($2 in chips) 
el_rasslo: posts small blind $0.01
Andry00701: posts big blind $0.02
*** HOLE CARDS ***
Dealt to Lorpugo [Ac 4c]
dsolmos: raises $0.04 to $0.06
MPut8: folds 
Lorpugo: calls $0.06
KAWABANGADU06: calls $0.06
el_rasslo: folds 
Andry00701: calls $0.04
*** FLOP *** [7s 8d 5d]
Andry00701: checks 
dsolmos: checks 
Lorpugo: checks 
KAWABANGADU06: bets $0.10
Andry00701: folds 
dsolmos: folds 
Lorpugo: folds 
Uncalled bet ($0.10) returned to KAWABANGADU06
KAWABANGADU06 collected $0.24 from pot
*** SUMMARY ***
Total pot $0.25 | Rake $0.01 
Board [7s 8d 5d]
Seat 1: dsolmos folded on the Flop
Seat 2: MPut8 folded before Flop (didn't bet)
Seat 3: Lorpugo folded on the Flop
Seat 4: KAWABANGADU06 (button) collected ($0.24)
Seat 5: el_rasslo (small blind) folded before Flop
Seat 6: Andry00701 (big blind) folded on the Flop



PokerStars Hand #240776609931:  Hold'em No Limit ($0.01/$0.02 USD) - 2022/12/29 12:32:47 ET
Table 'Idelsonia II' 6-max Seat #5 is the button
Seat 1: dsolmos ($2.29 in chips) 
Seat 2: MPut8 ($2.50 in chips) 
Seat 3: Lorpugo ($1.44 in chips) 
Seat 4: KAWABANGADU06 ($1.35 in chips) 
Seat 5: el_rasslo ($2.05 in chips) 
Seat 6: Andry00701 ($1.94 in chips) 
Andry00701: posts small blind $0.01
dsolmos: posts big blind $0.02
*** HOLE CARDS ***
Dealt to Lorpugo [3s 4s]
MPut8: folds 
Lorpugo: folds 
KAWABANGADU06: folds 
el_rasslo: folds 
Andry00701: raises $0.02 to $0.04
dsolmos: raises $0.08 to $0.12
Andry00701: calls $0.08
*** FLOP *** [7s Js Qh]
Andry00701: checks 
dsolmos: checks 
*** TURN *** [7s Js Qh] [Kc]
Andry00701: checks 
dsolmos: checks 
*** RIVER *** [7s Js Qh Kc] [4h]
Andry00701: checks 
dsolmos: bets $0.27
Andry00701: folds 
Uncalled bet ($0.27) returned to dsolmos
dsolmos collected $0.23 from pot
*** SUMMARY ***
Total pot $0.24 | Rake $0.01 
Board [7s Js Qh Kc 4h]
Seat 1: dsolmos (big blind) collected ($0.23)
Seat 2: MPut8 folded before Flop (didn't bet)
Seat 3: Lorpugo folded before Flop (didn't bet)
Seat 4: KAWABANGADU06 folded before Flop (didn't bet)
Seat 5: el_rasslo (button) folded before Flop (didn't bet)
Seat 6: Andry00701 (small blind) folded on the River



PokerStars Hand #240776629441:  Hold'em No Limit ($0.01/$0.02 USD) - 2022/12/29 12:33:39 ET
Table 'Idelsonia II' 6-max Seat #6 is the button
Seat 1: dsolmos ($2.40 in chips) 
Seat 2: MPut8 ($2.50 in chips) 
Seat 3: Lorpugo ($1.44 in chips) 
Seat 4: KAWABANGADU06 ($1.35 in chips) 
Seat 5: el_rasslo ($2.05 in chips) 
Seat 6: Andry00701 ($1.82 in chips) 
dsolmos: posts small blind $0.01
MPut8: posts big blind $0.02
*** HOLE CARDS ***
Dealt to Lorpugo [3s 5h]
Lorpugo: folds 
KAWABANGADU06: calls $0.02
el_rasslo: folds 
Andry00701: folds 
dsolmos: calls $0.01
MPut8: checks 
*** FLOP *** [4s Qd Th]
dsolmos: checks 
MPut8: checks 
KAWABANGADU06: bets $0.02
dsolmos: folds 
MPut8: folds 
Uncalled bet ($0.02) returned to KAWABANGADU06
KAWABANGADU06 collected $0.06 from pot
*** SUMMARY ***
Total pot $0.06 | Rake $0 
Board [4s Qd Th]
Seat 1: dsolmos (small blind) folded on the Flop
Seat 2: MPut8 (big blind) folded on the Flop
Seat 3: Lorpugo folded before Flop (didn't bet)
Seat 4: KAWABANGADU06 collected ($0.06)
Seat 5: el_rasslo folded before Flop (didn't bet)
Seat 6: Andry00701 (button) folded before Flop (didn't bet)



PokerStars Hand #240776645460:  Hold'em No Limit ($0.01/$0.02 USD) - 2022/12/29 12:34:22 ET
Table 'Idelsonia II' 6-max Seat #1 is the button
Seat 1: dsolmos ($2.38 in chips) 
Seat 2: MPut8 ($2.48 in chips) 
Seat 3: Lorpugo ($1.44 in chips) 
Seat 4: KAWABANGADU06 ($1.39 in chips) 
Seat 5: el_rasslo ($2.05 in chips) 
Seat 6: Andry00701 ($1.82 in chips) 
MPut8: posts small blind $0.01
Lorpugo: posts big blind $0.02
*** HOLE CARDS ***
Dealt to Lorpugo [7d 3h]
KAWABANGADU06: raises $0.04 to $0.06
el_rasslo: folds 
Andry00701: folds 
dsolmos: folds 
MPut8: folds 
Lorpugo: folds 
Uncalled bet ($0.04) returned to KAWABANGADU06
KAWABANGADU06 collected $0.05 from pot
*** SUMMARY ***
Total pot $0.05 | Rake $0 
Seat 1: dsolmos (button) folded before Flop (didn't bet)
Seat 2: MPut8 (small blind) folded before Flop
Seat 3: Lorpugo (big blind) folded before Flop
Seat 4: KAWABANGADU06 collected ($0.05)
Seat 5: el_rasslo folded before Flop (didn't bet)
Seat 6: Andry00701 folded before Flop (didn't bet)



PokerStars Hand #240776654323:  Hold'em No Limit ($0.01/$0.02 USD) - 2022/12/29 12:34:46 ET
Table 'Idelsonia II' 6-max Seat #2 is the button
Seat 1: dsolmos ($2.38 in chips) 
Seat 2: MPut8 ($2.47 in chips) 
Seat 3: Lorpugo ($1.42 in chips) 
Seat 4: KAWABANGADU06 ($1.42 in chips) 
Seat 5: el_rasslo ($2.05 in chips) 
Seat 6: Andry00701 ($1.82 in chips) 
Lorpugo: posts small blind $0.01
KAWABANGADU06: posts big blind $0.02
*** HOLE CARDS ***
Dealt to Lorpugo [3h Tc]
el_rasslo: calls $0.02
Andry00701: folds 
dsolmos: folds 
MPut8: folds 
Lorpugo: folds 
KAWABANGADU06: checks 
*** FLOP *** [3s 7d 8h]
KAWABANGADU06: bets $0.02
el_rasslo: calls $0.02
*** TURN *** [3s 7d 8h] [Qd]
KAWABANGADU06: bets $0.04
el_rasslo: calls $0.04
*** RIVER *** [3s 7d 8h Qd] [Th]
KAWABANGADU06: checks 
el_rasslo: checks 
*** SHOW DOWN ***
KAWABANGADU06: shows [8c 5s] (a pair of Eights)
el_rasslo: shows [Qs 9h] (a pair of Queens)
el_rasslo collected $0.16 from pot
*** SUMMARY ***
Total pot $0.17 | Rake $0.01 
Board [3s 7d 8h Qd Th]
Seat 1: dsolmos folded before Flop (didn't bet)
Seat 2: MPut8 (button) folded before Flop (didn't bet)
Seat 3: Lorpugo (small blind) folded before Flop
Seat 4: KAWABANGADU06 (big blind) showed [8c 5s] and lost with a pair of Eights
Seat 5: el_rasslo showed [Qs 9h] and won ($0.16) with a pair of Queens
Seat 6: Andry00701 folded before Flop (didn't bet)



PokerStars Hand #240776667598:  Hold'em No Limit ($0.01/$0.02 USD) - 2022/12/29 12:35:22 ET
Table 'Idelsonia II' 6-max Seat #3 is the button
Seat 1: dsolmos ($2.38 in chips) 
Seat 2: MPut8 ($2.47 in chips) 
Seat 3: Lorpugo ($1.41 in chips) 
Seat 4: KAWABANGADU06 ($1.34 in chips) 
Seat 5: el_rasslo ($2.13 in chips) 
Seat 6: Andry00701 ($1.82 in chips) 
KAWABANGADU06: posts small blind $0.01
el_rasslo: posts big blind $0.02
*** HOLE CARDS ***
Dealt to Lorpugo [9s 8s]
Andry00701: calls $0.02
dsolmos: folds 
MPut8: folds 
Lorpugo: raises $0.04 to $0.06
KAWABANGADU06: folds 
el_rasslo: calls $0.04
Andry00701: calls $0.04
*** FLOP *** [6c 8d Td]
el_rasslo: checks 
Andry00701: checks 
Lorpugo: bets $0.09
el_rasslo: folds 
Andry00701: folds 
Uncalled bet ($0.09) returned to Lorpugo
Lorpugo collected $0.18 from pot
Lorpugo: doesn't show hand 
*** SUMMARY ***
Total pot $0.19 | Rake $0.01 
Board [6c 8d Td]
Seat 1: dsolmos folded before Flop (didn't bet)
Seat 2: MPut8 folded before Flop (didn't bet)
Seat 3: Lorpugo (button) collected ($0.18)
Seat 4: KAWABANGADU06 (small blind) folded before Flop
Seat 5: el_rasslo (big blind) folded on the Flop
Seat 6: Andry00701 folded on the Flop



PokerStars Hand #240776680620:  Hold'em No Limit ($0.01/$0.02 USD) - 2022/12/29 12:35:56 ET
Table 'Idelsonia II' 6-max Seat #4 is the button
Seat 1: dsolmos ($2.38 in chips) 
Seat 2: MPut8 ($2.47 in chips) 
Seat 3: Lorpugo ($1.53 in chips) 
Seat 4: KAWABANGADU06 ($1.33 in chips) 
Seat 5: el_rasslo ($2.07 in chips) 
Seat 6: Andry00701 ($1.76 in chips) 
el_rasslo: posts small blind $0.01
Andry00701: posts big blind $0.02
*** HOLE CARDS ***
Dealt to Lorpugo [8c 3h]
dsolmos: folds 
MPut8: calls $0.02
Lorpugo: folds 
KAWABANGADU06: folds 
el_rasslo: calls $0.01
Andry00701: checks 
*** FLOP *** [6c Ts Ks]
el_rasslo: checks 
Andry00701: checks 
MPut8: checks 
*** TURN *** [6c Ts Ks] [Td]
el_rasslo: checks 
Andry00701: checks 
MPut8: checks 
*** RIVER *** [6c Ts Ks Td] [2h]
el_rasslo: checks 
Andry00701: checks 
MPut8: checks 
*** SHOW DOWN ***
el_rasslo: shows [Ad 5c] (a pair of Tens)
Andry00701: shows [Ah 9d] (a pair of Tens - Ace+King+Nine kicker)
MPut8: mucks hand 
Andry00701 collected $0.06 from pot
*** SUMMARY ***
Total pot $0.06 | Rake $0 
Board [6c Ts Ks Td 2h]
Seat 1: dsolmos folded before Flop (didn't bet)
Seat 2: MPut8 mucked [8s 7c]
Seat 3: Lorpugo folded before Flop (didn't bet)
Seat 4: KAWABANGADU06 (button) folded before Flop (didn't bet)
Seat 5: el_rasslo (small blind) showed [Ad 5c] and lost with a pair of Tens
Seat 6: Andry00701 (big blind) showed [Ah 9d] and won ($0.06) with a pair of Tens



PokerStars Hand #240776700455:  Hold'em No Limit ($0.01/$0.02 USD) - 2022/12/29 12:36:50 ET
Table 'Idelsonia II' 6-max Seat #5 is the button
Seat 1: dsolmos ($2.38 in chips) 
Seat 2: MPut8 ($2.45 in chips) 
Seat 3: Lorpugo ($1.53 in chips) 
Seat 4: KAWABANGADU06 ($1.33 in chips) 
Seat 5: el_rasslo ($2.05 in chips) 
Seat 6: Andry00701 ($1.80 in chips) 
Andry00701: posts small blind $0.01
dsolmos: posts big blind $0.02
*** HOLE CARDS ***
Dealt to Lorpugo [7c 9d]
MPut8: calls $0.02
Lorpugo: folds 
KAWABANGADU06: raises $0.04 to $0.06
el_rasslo: folds 
Andry00701: folds 
dsolmos: calls $0.04
MPut8: calls $0.04
*** FLOP *** [As 7d Jc]
dsolmos: checks 
MPut8: checks 
KAWABANGADU06: bets $0.06
dsolmos: calls $0.06
MPut8: folds 
*** TURN *** [As 7d Jc] [9h]
dsolmos: bets $0.10
KAWABANGADU06: calls $0.10
*** RIVER *** [As 7d Jc 9h] [7h]
dsolmos: bets $2.16 and is all-in
KAWABANGADU06: folds [Ac]
Uncalled bet ($2.16) returned to dsolmos
dsolmos collected $0.49 from pot
*** SUMMARY ***
Total pot $0.51 | Rake $0.02 
Board [As 7d Jc 9h 7h]
Seat 1: dsolmos (big blind) collected ($0.49)
Seat 2: MPut8 folded on the Flop
Seat 3: Lorpugo folded before Flop (didn't bet)
Seat 4: KAWABANGADU06 folded on the River
Seat 5: el_rasslo (button) folded before Flop (didn't bet)
Seat 6: Andry00701 (small blind) folded before Flop



PokerStars Hand #240776734253:  Hold'em No Limit ($0.01/$0.02 USD) - 2022/12/29 12:38:21 ET
Table 'Idelsonia II' 6-max Seat #6 is the button
Seat 1: dsolmos ($2.65 in chips) 
Seat 2: MPut8 ($2.39 in chips) 
Seat 3: Lorpugo ($1.53 in chips) 
Seat 4: KAWABANGADU06 ($1.11 in chips) 
Seat 5: el_rasslo ($2.05 in chips) 
Seat 6: Andry00701 ($1.79 in chips) 
dsolmos: posts small blind $0.01
MPut8: posts big blind $0.02
*** HOLE CARDS ***
Dealt to Lorpugo [Jd 3d]
Lorpugo: folds 
KAWABANGADU06: calls $0.02
el_rasslo: calls $0.02
Andry00701: folds 
dsolmos: folds 
MPut8: checks 
*** FLOP *** [4d Ac Ad]
MPut8: checks 
KAWABANGADU06: bets $0.02
el_rasslo: folds 
MPut8: folds 
Uncalled bet ($0.02) returned to KAWABANGADU06
KAWABANGADU06 collected $0.07 from pot
*** SUMMARY ***
Total pot $0.07 | Rake $0 
Board [4d Ac Ad]
Seat 1: dsolmos (small blind) folded before Flop
Seat 2: MPut8 (big blind) folded on the Flop
Seat 3: Lorpugo folded before Flop (didn't bet)
Seat 4: KAWABANGADU06 collected ($0.07)
Seat 5: el_rasslo folded on the Flop
Seat 6: Andry00701 (button) folded before Flop (didn't bet)



PokerStars Hand #240776745719:  Hold'em No Limit ($0.01/$0.02 USD) - 2022/12/29 12:38:53 ET
Table 'Idelsonia II' 6-max Seat #1 is the button
Seat 1: dsolmos ($2.64 in chips) 
Seat 2: MPut8 ($2.37 in chips) 
Seat 3: Lorpugo ($1.53 in chips) 
Seat 4: KAWABANGADU06 ($1.16 in chips) 
Seat 5: el_rasslo ($2.03 in chips) 
Seat 6: Andry00701 ($1.79 in chips) 
MPut8: posts small blind $0.01
Lorpugo: posts big blind $0.02
*** HOLE CARDS ***
Dealt to Lorpugo [8c Tc]
KAWABANGADU06: folds 
el_rasslo: folds 
Andry00701: calls $0.02
dsolmos: folds 
MPut8: folds 
Lorpugo: checks 
*** FLOP *** [9h 6s Kd]
Lorpugo: bets $0.02
Andry00701: calls $0.02
*** TURN *** [9h 6s Kd] [Ts]
Lorpugo: bets $0.06
Andry00701: folds 
Uncalled bet ($0.06) returned to Lorpugo
Lorpugo collected $0.09 from pot
Lorpugo: doesn't show hand 
*** SUMMARY ***
Total pot $0.09 | Rake $0 
Board [9h 6s Kd Ts]
Seat 1: dsolmos (button) folded before Flop (didn't bet)
Seat 2: MPut8 (small blind) folded before Flop
Seat 3: Lorpugo (big blind) collected ($0.09)
Seat 4: KAWABANGADU06 folded before Flop (didn't bet)
Seat 5: el_rasslo folded before Flop (didn't bet)
Seat 6: Andry00701 folded on the Turn



PokerStars Hand #240776760726:  Hold'em No Limit ($0.01/$0.02 USD) - 2022/12/29 12:39:33 ET
Table 'Idelsonia II' 6-max Seat #2 is the button
Seat 1: dsolmos ($2.64 in chips) 
Seat 2: MPut8 ($2.36 in chips) 
Seat 3: Lorpugo ($1.58 in chips) 
Seat 4: KAWABANGADU06 ($1.16 in chips) 
Seat 5: el_rasslo ($2.03 in chips) 
Seat 6: Andry00701 ($1.75 in chips) 
Lorpugo: posts small blind $0.01
KAWABANGADU06: posts big blind $0.02
*** HOLE CARDS ***
Dealt to Lorpugo [2c 4s]
el_rasslo: calls $0.02
Andry00701: folds 
dsolmos: folds 
MPut8: calls $0.02
Lorpugo: folds 
KAWABANGADU06: checks 
*** FLOP *** [3h 9d 8d]
KAWABANGADU06: checks 
el_rasslo: bets $0.10
MPut8: calls $0.10
KAWABANGADU06: folds 
*** TURN *** [3h 9d 8d] [9s]
el_rasslo: bets $0.10
MPut8: folds 
Uncalled bet ($0.10) returned to el_rasslo
el_rasslo collected $0.26 from pot
*** SUMMARY ***
Total pot $0.27 | Rake $0.01 
Board [3h 9d 8d 9s]
Seat 1: dsolmos folded before Flop (didn't bet)
Seat 2: MPut8 (button) folded on the Turn
Seat 3: Lorpugo (small blind) folded before Flop
Seat 4: KAWABANGADU06 (big blind) folded on the Flop
Seat 5: el_rasslo collected ($0.26)
Seat 6: Andry00701 folded before Flop (didn't bet)



PokerStars Hand #240776776117:  Hold'em No Limit ($0.01/$0.02 USD) - 2022/12/29 12:40:15 ET
Table 'Idelsonia II' 6-max Seat #3 is the button
Seat 1: dsolmos ($2.64 in chips) 
Seat 2: MPut8 ($2.24 in chips) 
Seat 3: Lorpugo ($1.57 in chips) 
Seat 4: KAWABANGADU06 ($1.14 in chips) 
Seat 5: el_rasslo ($2.17 in chips) 
Seat 6: Andry00701 ($1.75 in chips) 
KAWABANGADU06: posts small blind $0.01
el_rasslo: posts big blind $0.02
*** HOLE CARDS ***
Dealt to Lorpugo [9d 2d]
Andry00701: folds 
dsolmos: folds 
Andry00701 leaves the table
MPut8: folds 
Lorpugo: folds 
KAWABANGADU06: calls $0.01
el_rasslo: checks 
*** FLOP *** [3s 5d Js]
KAWABANGADU06: bets $0.02
el_rasslo: calls $0.02
*** TURN *** [3s 5d Js] [Jh]
KAWABANGADU06: bets $0.02
el_rasslo: calls $0.02
*** RIVER *** [3s 5d Js Jh] [7c]
fila2748 joins the table at seat #6 
KAWABANGADU06: bets $0.02
el_rasslo: calls $0.02
*** SHOW DOWN ***
KAWABANGADU06: shows [2s Qs] (a pair of Jacks)
el_rasslo: shows [4h Ad] (a pair of Jacks - Ace kicker)
el_rasslo collected $0.15 from pot
*** SUMMARY ***
Total pot $0.16 | Rake $0.01 
Board [3s 5d Js Jh 7c]
Seat 1: dsolmos folded before Flop (didn't bet)
Seat 2: MPut8 folded before Flop (didn't bet)
Seat 3: Lorpugo (button) folded before Flop (didn't bet)
Seat 4: KAWABANGADU06 (small blind) showed [2s Qs] and lost with a pair of Jacks
Seat 5: el_rasslo (big blind) showed [4h Ad] and won ($0.15) with a pair of Jacks
Seat 6: Andry00701 folded before Flop (didn't bet)



PokerStars Hand #240776790169:  Hold'em No Limit ($0.01/$0.02 USD) - 2022/12/29 12:40:53 ET
Table 'Idelsonia II' 6-max Seat #4 is the button
Seat 1: dsolmos ($2.64 in chips) 
Seat 2: MPut8 ($2.24 in chips) 
Seat 3: Lorpugo ($1.57 in chips) 
Seat 4: KAWABANGADU06 ($1.06 in chips) 
Seat 5: el_rasslo ($2.24 in chips) 
Seat 6: fila2748 ($2 in chips) 
el_rasslo: posts small blind $0.01
fila2748: posts big blind $0.02
*** HOLE CARDS ***
Dealt to Lorpugo [Td 8s]
dsolmos: folds 
MPut8 has timed out
MPut8: folds 
Lorpugo: folds 
KAWABANGADU06: folds 
el_rasslo: calls $0.01
fila2748: checks 
*** FLOP *** [4h 8c 3d]
el_rasslo: checks 
fila2748: checks 
*** TURN *** [4h 8c 3d] [9d]
el_rasslo: checks 
fila2748: checks 
*** RIVER *** [4h 8c 3d 9d] [2d]
el_rasslo: checks 
fila2748: checks 
*** SHOW DOWN ***
el_rasslo: shows [3s 6d] (a pair of Threes)
fila2748: shows [9h Qh] (a pair of Nines)
fila2748 collected $0.04 from pot
*** SUMMARY ***
Total pot $0.04 | Rake $0 
Board [4h 8c 3d 9d 2d]
Seat 1: dsolmos folded before Flop (didn't bet)
Seat 2: MPut8 folded before Flop (didn't bet)
Seat 3: Lorpugo folded before Flop (didn't bet)
Seat 4: KAWABANGADU06 (button) folded before Flop (didn't bet)
Seat 5: el_rasslo (small blind) showed [3s 6d] and lost with a pair of Threes
Seat 6: fila2748 (big blind) showed [9h Qh] and won ($0.04) with a pair of Nines



