PokerStars Hand #240822542380:  Hold'em No Limit ($0.01/$0.02 USD) - 2022/12/31 13:35:56 ET
Table 'Markab III' 6-max Seat #2 is the button
Seat 2: constantin-z02 ($1.87 in chips) 
Seat 3: EvoLion74 ($1.74 in chips) 
Seat 4: Lorpugo ($1.60 in chips) 
Seat 5: frlef65 ($3.52 in chips) 
EvoLion74: posts small blind $0.01
Lorpugo: posts big blind $0.02
*** HOLE CARDS ***
Dealt to Lorpugo [3s 8s]
Spiderrz joins the table at seat #1 
frlef65: folds 
constantin-z02: folds 
EvoLion74: folds 
Uncalled bet ($0.01) returned to Lorpugo
Lorpugo collected $0.02 from pot
Lorpugo: doesn't show hand 
*** SUMMARY ***
Total pot $0.02 | Rake $0 
Seat 2: constantin-z02 (button) folded before Flop (didn't bet)
Seat 3: EvoLion74 (small blind) folded before Flop
Seat 4: Lorpugo (big blind) collected ($0.02)
Seat 5: frlef65 folded before Flop (didn't bet)



PokerStars Hand #240822546704:  Hold'em No Limit ($0.01/$0.02 USD) - 2022/12/31 13:36:10 ET
Table 'Markab III' 6-max Seat #3 is the button
Seat 2: constantin-z02 ($1.87 in chips) 
Seat 3: EvoLion74 ($1.73 in chips) 
Seat 4: Lorpugo ($1.61 in chips) 
Seat 5: frlef65 ($3.52 in chips) 
Lorpugo: posts small blind $0.01
frlef65: posts big blind $0.02
*** HOLE CARDS ***
Dealt to Lorpugo [4s 6h]
constantin-z02: raises $0.02 to $0.04
EvoLion74: raises $0.08 to $0.12
Lorpugo: folds 
frlef65: folds 
constantin-z02: folds 
Uncalled bet ($0.08) returned to EvoLion74
EvoLion74 collected $0.11 from pot
EvoLion74: doesn't show hand 
*** SUMMARY ***
Total pot $0.11 | Rake $0 
Seat 2: constantin-z02 folded before Flop
Seat 3: EvoLion74 (button) collected ($0.11)
Seat 4: Lorpugo (small blind) folded before Flop
Seat 5: frlef65 (big blind) folded before Flop



PokerStars Hand #240822552709:  Hold'em No Limit ($0.01/$0.02 USD) - 2022/12/31 13:36:30 ET
Table 'Markab III' 6-max Seat #4 is the button
Seat 2: constantin-z02 ($1.83 in chips) 
Seat 3: EvoLion74 ($1.80 in chips) 
Seat 4: Lorpugo ($1.60 in chips) 
Seat 5: frlef65 ($3.50 in chips) 
Seat 6: Kléber280 ($0.70 in chips) 
frlef65: posts small blind $0.01
Kléber280: posts big blind $0.02
*** HOLE CARDS ***
Dealt to Lorpugo [5h 2h]
constantin-z02: folds 
EvoLion74: folds 
Lorpugo: folds 
frlef65: calls $0.01
Kléber280 has timed out
Kléber280: checks 
*** FLOP *** [3s Qs 8s]
frlef65: bets $0.02
Kléber280 has timed out
Kléber280: folds 
Uncalled bet ($0.02) returned to frlef65
frlef65 collected $0.04 from pot
*** SUMMARY ***
Total pot $0.04 | Rake $0 
Board [3s Qs 8s]
Seat 2: constantin-z02 folded before Flop (didn't bet)
Seat 3: EvoLion74 folded before Flop (didn't bet)
Seat 4: Lorpugo (button) folded before Flop (didn't bet)
Seat 5: frlef65 (small blind) collected ($0.04)
Seat 6: Kléber280 (big blind) folded on the Flop



PokerStars Hand #240822566984:  Hold'em No Limit ($0.01/$0.02 USD) - 2022/12/31 13:37:17 ET
Table 'Markab III' 6-max Seat #5 is the button
Seat 2: constantin-z02 ($1.83 in chips) 
Seat 3: EvoLion74 ($1.80 in chips) 
Seat 4: Lorpugo ($1.60 in chips) 
Seat 5: frlef65 ($3.52 in chips) 
constantin-z02: posts small blind $0.01
EvoLion74: posts big blind $0.02
*** HOLE CARDS ***
Dealt to Lorpugo [7c Jh]
Lorpugo: folds 
frlef65: calls $0.02
constantin-z02: calls $0.01
EvoLion74: checks 
*** FLOP *** [9h 4d Jc]
constantin-z02: checks 
EvoLion74: checks 
frlef65: bets $0.06
constantin-z02: folds 
EvoLion74: folds 
Uncalled bet ($0.06) returned to frlef65
frlef65 collected $0.06 from pot
*** SUMMARY ***
Total pot $0.06 | Rake $0 
Board [9h 4d Jc]
Seat 2: constantin-z02 (small blind) folded on the Flop
Seat 3: EvoLion74 (big blind) folded on the Flop
Seat 4: Lorpugo folded before Flop (didn't bet)
Seat 5: frlef65 (button) collected ($0.06)



PokerStars Hand #240822581012:  Hold'em No Limit ($0.01/$0.02 USD) - 2022/12/31 13:38:05 ET
Table 'Markab III' 6-max Seat #2 is the button
Seat 2: constantin-z02 ($1.81 in chips) 
Seat 3: EvoLion74 ($1.78 in chips) 
Seat 4: Lorpugo ($1.60 in chips) 
Seat 5: frlef65 ($3.56 in chips) 
EvoLion74: posts small blind $0.01
Lorpugo: posts big blind $0.02
*** HOLE CARDS ***
Dealt to Lorpugo [Th 3s]
frlef65: folds 
constantin-z02: raises $0.02 to $0.04
EvoLion74: raises $0.08 to $0.12
Lorpugo: folds 
constantin-z02: folds 
Uncalled bet ($0.08) returned to EvoLion74
Spiderrz leaves the table
EvoLion74 collected $0.10 from pot
EvoLion74: doesn't show hand 
*** SUMMARY ***
Total pot $0.10 | Rake $0 
Seat 2: constantin-z02 (button) folded before Flop
Seat 3: EvoLion74 (small blind) collected ($0.10)
Seat 4: Lorpugo (big blind) folded before Flop
Seat 5: frlef65 folded before Flop (didn't bet)



PokerStars Hand #240822590931:  Hold'em No Limit ($0.01/$0.02 USD) - 2022/12/31 13:38:38 ET
Table 'Markab III' 6-max Seat #3 is the button
Seat 2: constantin-z02 ($1.77 in chips) 
Seat 3: EvoLion74 ($1.84 in chips) 
Seat 4: Lorpugo ($1.58 in chips) 
Seat 5: frlef65 ($3.56 in chips) 
Lorpugo: posts small blind $0.01
frlef65: posts big blind $0.02
*** HOLE CARDS ***
Dealt to Lorpugo [Ks Jh]
alexfm88 joins the table at seat #1 
constantin-z02 has timed out
constantin-z02: folds 
EvoLion74: raises $0.03 to $0.05
Lorpugo: calls $0.04
constantin-z02 is disconnected 
frlef65: calls $0.03
*** FLOP *** [4c 9h As]
Lorpugo: checks 
frlef65: bets $0.07
EvoLion74: folds 
Lorpugo: folds 
Uncalled bet ($0.07) returned to frlef65
frlef65 collected $0.14 from pot
*** SUMMARY ***
Total pot $0.15 | Rake $0.01 
Board [4c 9h As]
Seat 2: constantin-z02 folded before Flop (didn't bet)
Seat 3: EvoLion74 (button) folded on the Flop
Seat 4: Lorpugo (small blind) folded on the Flop
Seat 5: frlef65 (big blind) collected ($0.14)



PokerStars Hand #240822603720:  Hold'em No Limit ($0.01/$0.02 USD) - 2022/12/31 13:39:21 ET
Table 'Markab III' 6-max Seat #4 is the button
Seat 1: alexfm88 ($1.60 in chips) 
Seat 3: EvoLion74 ($1.79 in chips) 
Seat 4: Lorpugo ($1.53 in chips) 
Seat 5: frlef65 ($3.65 in chips) 
Seat 6: Kléber280 ($0.68 in chips) 
frlef65: posts small blind $0.01
Kléber280: posts big blind $0.02
alexfm88: posts big blind $0.02
*** HOLE CARDS ***
Dealt to Lorpugo [Js 6h]
alexfm88: checks 
EvoLion74: folds 
Lorpugo: folds 
frlef65: folds 
Kléber280: checks 
*** FLOP *** [8h Kh Qd]
Kléber280: checks 
alexfm88: checks 
*** TURN *** [8h Kh Qd] [2s]
Kléber280: bets $0.02
alexfm88: folds 
Uncalled bet ($0.02) returned to Kléber280
Kléber280 collected $0.05 from pot
*** SUMMARY ***
Total pot $0.05 | Rake $0 
Board [8h Kh Qd 2s]
Seat 1: alexfm88 folded on the Turn (didn't bet)
Seat 3: EvoLion74 folded before Flop (didn't bet)
Seat 4: Lorpugo (button) folded before Flop (didn't bet)
Seat 5: frlef65 (small blind) folded before Flop
Seat 6: Kléber280 (big blind) collected ($0.05)



PokerStars Hand #240822612528:  Hold'em No Limit ($0.01/$0.02 USD) - 2022/12/31 13:39:51 ET
Table 'Markab III' 6-max Seat #5 is the button
Seat 1: alexfm88 ($1.58 in chips) 
Seat 3: EvoLion74 ($1.79 in chips) 
Seat 4: Lorpugo ($1.53 in chips) 
Seat 5: frlef65 ($3.64 in chips) 
Seat 6: Kléber280 ($0.71 in chips) 
Kléber280: posts small blind $0.01
alexfm88: posts big blind $0.02
*** HOLE CARDS ***
Dealt to Lorpugo [As 3d]
EvoLion74: folds 
Lorpugo: raises $0.04 to $0.06
frlef65: calls $0.06
Kléber280: calls $0.05
alexfm88: calls $0.04
*** FLOP *** [2d Qc 3s]
Kléber280: checks 
alexfm88: bets $0.04
EvoLion74 leaves the table
Lorpugo: calls $0.04
frlef65: calls $0.04
divindor_dnipro joins the table at seat #3 
Kléber280: folds 
*** TURN *** [2d Qc 3s] [4c]
alexfm88: bets $0.08
Lorpugo: calls $0.08
frlef65: raises $0.08 to $0.16
alexfm88: calls $0.08
Lorpugo: calls $0.08
*** RIVER *** [2d Qc 3s 4c] [2s]
alexfm88: checks 
Lorpugo: checks 
frlef65: bets $0.81
alexfm88: calls $0.81
Lorpugo: folds 
*** SHOW DOWN ***
frlef65: shows [6h 3h] (two pair, Threes and Deuces)
alexfm88: shows [7c 7d] (two pair, Sevens and Deuces)
alexfm88 collected $2.37 from pot
*** SUMMARY ***
Total pot $2.46 | Rake $0.09 
Board [2d Qc 3s 4c 2s]
Seat 1: alexfm88 (big blind) showed [7c 7d] and won ($2.37) with two pair, Sevens and Deuces
Seat 3: EvoLion74 folded before Flop (didn't bet)
Seat 4: Lorpugo folded on the River
Seat 5: frlef65 (button) showed [6h 3h] and lost with two pair, Threes and Deuces
Seat 6: Kléber280 (small blind) folded on the Flop



PokerStars Hand #240822640744:  Hold'em No Limit ($0.01/$0.02 USD) - 2022/12/31 13:41:25 ET
Table 'Markab III' 6-max Seat #6 is the button
Seat 1: alexfm88 ($2.88 in chips) 
Seat 3: divindor_dnipro ($1 in chips) 
Seat 4: Lorpugo ($1.27 in chips) 
Seat 5: frlef65 ($2.57 in chips) 
Seat 6: Kléber280 ($0.65 in chips) 
alexfm88: posts small blind $0.01
divindor_dnipro: posts big blind $0.02
*** HOLE CARDS ***
Dealt to Lorpugo [Ah 6s]
Lorpugo: raises $0.04 to $0.06
frlef65: calls $0.06
Kléber280: calls $0.06
alexfm88: calls $0.05
divindor_dnipro: calls $0.04
*** FLOP *** [6h 4c 9c]
alexfm88: bets $0.04
divindor_dnipro: calls $0.04
Lorpugo: calls $0.04
frlef65: calls $0.04
Kléber280: raises $0.49 to $0.53
alexfm88: calls $0.49
divindor_dnipro: folds 
Lorpugo: folds 
frlef65: folds 
*** TURN *** [6h 4c 9c] [Tc]
alexfm88: checks 
Kléber280: bets $0.06 and is all-in
alexfm88: calls $0.06
*** RIVER *** [6h 4c 9c Tc] [3h]
*** SHOW DOWN ***
alexfm88: shows [2c Ac] (a flush, Ace high)
Kléber280: shows [4h 4d] (three of a kind, Fours)
alexfm88 collected $1.54 from pot
*** SUMMARY ***
Total pot $1.60 | Rake $0.06 
Board [6h 4c 9c Tc 3h]
Seat 1: alexfm88 (small blind) showed [2c Ac] and won ($1.54) with a flush, Ace high
Seat 3: divindor_dnipro (big blind) folded on the Flop
Seat 4: Lorpugo folded on the Flop
Seat 5: frlef65 folded on the Flop
Seat 6: Kléber280 (button) showed [4h 4d] and lost with three of a kind, Fours



PokerStars Hand #240822665735:  Hold'em No Limit ($0.01/$0.02 USD) - 2022/12/31 13:42:51 ET
Table 'Markab III' 6-max Seat #1 is the button
Seat 1: alexfm88 ($3.77 in chips) 
Seat 3: divindor_dnipro ($0.90 in chips) 
Seat 4: Lorpugo ($1.17 in chips) 
Seat 5: frlef65 ($2.47 in chips) 
divindor_dnipro: posts small blind $0.01
Lorpugo: posts big blind $0.02
*** HOLE CARDS ***
Dealt to Lorpugo [Jd Kc]
frlef65: folds 
alexfm88: calls $0.02
divindor_dnipro: calls $0.01
Kléber280 is disconnected 
Lorpugo: raises $0.02 to $0.04
alexfm88: calls $0.02
divindor_dnipro: calls $0.02
*** FLOP *** [6d Qh Kd]
divindor_dnipro: checks 
Lorpugo: bets $0.08
alexfm88: calls $0.08
divindor_dnipro: folds 
*** TURN *** [6d Qh Kd] [8s]
Lorpugo: bets $0.18
alexfm88: folds 
Uncalled bet ($0.18) returned to Lorpugo
Lorpugo collected $0.27 from pot
Lorpugo: doesn't show hand 
*** SUMMARY ***
Total pot $0.28 | Rake $0.01 
Board [6d Qh Kd 8s]
Seat 1: alexfm88 (button) folded on the Turn
Seat 3: divindor_dnipro (small blind) folded on the Flop
Seat 4: Lorpugo (big blind) collected ($0.27)
Seat 5: frlef65 folded before Flop (didn't bet)



PokerStars Hand #240822678104:  Hold'em No Limit ($0.01/$0.02 USD) - 2022/12/31 13:43:33 ET
Table 'Markab III' 6-max Seat #3 is the button
Seat 1: alexfm88 ($3.65 in chips) 
Seat 3: divindor_dnipro ($0.86 in chips) 
Seat 4: Lorpugo ($1.32 in chips) 
Seat 5: frlef65 ($2.47 in chips) 
Lorpugo: posts small blind $0.01
frlef65: posts big blind $0.02
*** HOLE CARDS ***
Dealt to Lorpugo [Kh Jh]
alexfm88: calls $0.02
divindor_dnipro: calls $0.02
Lorpugo: calls $0.01
frlef65: checks 
*** FLOP *** [5h As 5d]
Lorpugo: checks 
frlef65: bets $0.04
alexfm88: folds 
divindor_dnipro: folds 
Lorpugo: folds 
Uncalled bet ($0.04) returned to frlef65
frlef65 collected $0.08 from pot
*** SUMMARY ***
Total pot $0.08 | Rake $0 
Board [5h As 5d]
Seat 1: alexfm88 folded on the Flop
Seat 3: divindor_dnipro (button) folded on the Flop
Seat 4: Lorpugo (small blind) folded on the Flop
Seat 5: frlef65 (big blind) collected ($0.08)



PokerStars Hand #240822686431:  Hold'em No Limit ($0.01/$0.02 USD) - 2022/12/31 13:44:01 ET
Table 'Markab III' 6-max Seat #4 is the button
Seat 1: alexfm88 ($3.63 in chips) 
Seat 3: divindor_dnipro ($0.84 in chips) 
Seat 4: Lorpugo ($1.30 in chips) 
Seat 5: frlef65 ($2.53 in chips) 
frlef65: posts small blind $0.01
alexfm88: posts big blind $0.02
*** HOLE CARDS ***
Dealt to Lorpugo [Qh Kc]
divindor_dnipro: folds 
Lorpugo: raises $0.04 to $0.06
frlef65: folds 
alexfm88: calls $0.04
*** FLOP *** [As 3h 5s]
alexfm88: checks 
Lorpugo: checks 
*** TURN *** [As 3h 5s] [Ts]
alexfm88: checks 
Lorpugo: checks 
*** RIVER *** [As 3h 5s Ts] [Ac]
alexfm88: checks 
Lorpugo: checks 
*** SHOW DOWN ***
alexfm88: shows [8h 6h] (a pair of Aces)
Lorpugo: shows [Qh Kc] (a pair of Aces - King kicker)
Lorpugo collected $0.13 from pot
*** SUMMARY ***
Total pot $0.13 | Rake $0 
Board [As 3h 5s Ts Ac]
Seat 1: alexfm88 (big blind) showed [8h 6h] and lost with a pair of Aces
Seat 3: divindor_dnipro folded before Flop (didn't bet)
Seat 4: Lorpugo (button) showed [Qh Kc] and won ($0.13) with a pair of Aces
Seat 5: frlef65 (small blind) folded before Flop



PokerStars Hand #240822700525:  Hold'em No Limit ($0.01/$0.02 USD) - 2022/12/31 13:44:49 ET
Table 'Markab III' 6-max Seat #5 is the button
Seat 1: alexfm88 ($3.57 in chips) 
Seat 3: divindor_dnipro ($0.84 in chips) 
Seat 4: Lorpugo ($1.37 in chips) 
Seat 5: frlef65 ($2.52 in chips) 
alexfm88: posts small blind $0.01
divindor_dnipro: posts big blind $0.02
*** HOLE CARDS ***
Dealt to Lorpugo [7c Ks]
Lorpugo: folds 
frlef65: folds 
alexfm88: calls $0.01
divindor_dnipro: checks 
*** FLOP *** [Ts Ah As]
alexfm88: bets $0.02
divindor_dnipro: calls $0.02
*** TURN *** [Ts Ah As] [Jh]
alexfm88: bets $0.02
divindor_dnipro: calls $0.02
*** RIVER *** [Ts Ah As Jh] [Jd]
alexfm88: checks 
divindor_dnipro: checks 
*** SHOW DOWN ***
alexfm88: shows [4s Kc] (two pair, Aces and Jacks)
divindor_dnipro: mucks hand 
alexfm88 collected $0.12 from pot
*** SUMMARY ***
Total pot $0.12 | Rake $0 
Board [Ts Ah As Jh Jd]
Seat 1: alexfm88 (small blind) showed [4s Kc] and won ($0.12) with two pair, Aces and Jacks
Seat 3: divindor_dnipro (big blind) mucked [8s 9s]
Seat 4: Lorpugo folded before Flop (didn't bet)
Seat 5: frlef65 (button) folded before Flop (didn't bet)



PokerStars Hand #240822711159:  Hold'em No Limit ($0.01/$0.02 USD) - 2022/12/31 13:45:25 ET
Table 'Markab III' 6-max Seat #1 is the button
Seat 1: alexfm88 ($3.63 in chips) 
Seat 3: divindor_dnipro ($0.78 in chips) 
Seat 4: Lorpugo ($1.37 in chips) 
Seat 5: frlef65 ($2.52 in chips) 
divindor_dnipro: posts small blind $0.01
Lorpugo: posts big blind $0.02
*** HOLE CARDS ***
Dealt to Lorpugo [As 4h]
frlef65: raises $0.02 to $0.04
alexfm88: calls $0.04
divindor_dnipro: folds 
Lorpugo: calls $0.02
*** FLOP *** [Js 5d 7h]
Lorpugo: checks 
frlef65: bets $0.13
alexfm88: calls $0.13
Lorpugo: folds 
*** TURN *** [Js 5d 7h] [9c]
frlef65: bets $0.38
alexfm88: folds 
Uncalled bet ($0.38) returned to frlef65
frlef65 collected $0.38 from pot
*** SUMMARY ***
Total pot $0.39 | Rake $0.01 
Board [Js 5d 7h 9c]
Seat 1: alexfm88 (button) folded on the Turn
Seat 3: divindor_dnipro (small blind) folded before Flop
Seat 4: Lorpugo (big blind) folded on the Flop
Seat 5: frlef65 collected ($0.38)



PokerStars Hand #240822723907:  Hold'em No Limit ($0.01/$0.02 USD) - 2022/12/31 13:46:08 ET
Table 'Markab III' 6-max Seat #3 is the button
Seat 1: alexfm88 ($3.46 in chips) 
Seat 3: divindor_dnipro ($0.77 in chips) 
Seat 4: Lorpugo ($1.33 in chips) 
Seat 5: frlef65 ($2.73 in chips) 
Lorpugo: posts small blind $0.01
frlef65: posts big blind $0.02
*** HOLE CARDS ***
Dealt to Lorpugo [4h 2s]
alexfm88: calls $0.02
divindor_dnipro: calls $0.02
Lorpugo: folds 
frlef65: checks 
*** FLOP *** [8d 9d 5s]
frlef65: checks 
alexfm88: bets $0.04
divindor_dnipro: calls $0.04
frlef65: folds 
*** TURN *** [8d 9d 5s] [7c]
alexfm88: bets $0.04
divindor_dnipro: calls $0.04
*** RIVER *** [8d 9d 5s 7c] [9h]
alexfm88: bets $0.06
divindor_dnipro: calls $0.06
*** SHOW DOWN ***
alexfm88: shows [Td Jc] (a straight, Seven to Jack)
divindor_dnipro: mucks hand 
alexfm88 collected $0.34 from pot
*** SUMMARY ***
Total pot $0.35 | Rake $0.01 
Board [8d 9d 5s 7c 9h]
Seat 1: alexfm88 showed [Td Jc] and won ($0.34) with a straight, Seven to Jack
Seat 3: divindor_dnipro (button) mucked [Tc Th]
Seat 4: Lorpugo (small blind) folded before Flop
Seat 5: frlef65 (big blind) folded on the Flop



PokerStars Hand #240822737519:  Hold'em No Limit ($0.01/$0.02 USD) - 2022/12/31 13:46:55 ET
Table 'Markab III' 6-max Seat #4 is the button
Seat 1: alexfm88 ($3.64 in chips) 
Seat 3: divindor_dnipro ($0.61 in chips) 
Seat 4: Lorpugo ($1.32 in chips) 
Seat 5: frlef65 ($2.71 in chips) 
frlef65: posts small blind $0.01
alexfm88: posts big blind $0.02
*** HOLE CARDS ***
Dealt to Lorpugo [As 8c]
divindor_dnipro: folds 
Lorpugo: raises $0.04 to $0.06
frlef65: calls $0.05
alexfm88: folds 
*** FLOP *** [8s 4s Kd]
frlef65: checks 
Lorpugo: bets $0.09
frlef65: raises $0.32 to $0.41
Lorpugo: folds 
Uncalled bet ($0.32) returned to frlef65
frlef65 collected $0.31 from pot
*** SUMMARY ***
Total pot $0.32 | Rake $0.01 
Board [8s 4s Kd]
Seat 1: alexfm88 (big blind) folded before Flop
Seat 3: divindor_dnipro folded before Flop (didn't bet)
Seat 4: Lorpugo (button) folded on the Flop
Seat 5: frlef65 (small blind) collected ($0.31)



PokerStars Hand #240822747727:  Hold'em No Limit ($0.01/$0.02 USD) - 2022/12/31 13:47:30 ET
Table 'Markab III' 6-max Seat #5 is the button
Seat 1: alexfm88 ($3.62 in chips) 
Seat 3: divindor_dnipro ($0.61 in chips) 
Seat 4: Lorpugo ($1.17 in chips) 
Seat 5: frlef65 ($2.87 in chips) 
alexfm88: posts small blind $0.01
divindor_dnipro: posts big blind $0.02
*** HOLE CARDS ***
Dealt to Lorpugo [4c Kd]
Lorpugo: folds 
frlef65: folds 
alexfm88: calls $0.01
divindor_dnipro: checks 
*** FLOP *** [Tc Ts Qs]
alexfm88: checks 
divindor_dnipro: checks 
*** TURN *** [Tc Ts Qs] [7c]
alexfm88: checks 
divindor_dnipro: checks 
*** RIVER *** [Tc Ts Qs 7c] [Qh]
alexfm88: checks 
divindor_dnipro: checks 
*** SHOW DOWN ***
alexfm88: shows [6h 4d] (two pair, Queens and Tens)
divindor_dnipro: shows [Jd 8s] (two pair, Queens and Tens - Jack kicker)
divindor_dnipro collected $0.04 from pot
*** SUMMARY ***
Total pot $0.04 | Rake $0 
Board [Tc Ts Qs 7c Qh]
Seat 1: alexfm88 (small blind) showed [6h 4d] and lost with two pair, Queens and Tens
Seat 3: divindor_dnipro (big blind) showed [Jd 8s] and won ($0.04) with two pair, Queens and Tens
Seat 4: Lorpugo folded before Flop (didn't bet)
Seat 5: frlef65 (button) folded before Flop (didn't bet)



PokerStars Hand #240822754119:  Hold'em No Limit ($0.01/$0.02 USD) - 2022/12/31 13:47:51 ET
Table 'Markab III' 6-max Seat #1 is the button
Seat 1: alexfm88 ($3.60 in chips) 
Seat 3: divindor_dnipro ($0.63 in chips) 
Seat 4: Lorpugo ($1.17 in chips) 
Seat 5: frlef65 ($2.87 in chips) 
divindor_dnipro: posts small blind $0.01
Lorpugo: posts big blind $0.02
*** HOLE CARDS ***
Dealt to Lorpugo [Qh Jh]
frlef65: folds 
alexfm88: calls $0.02
divindor_dnipro: calls $0.01
Lorpugo: raises $0.06 to $0.08
alexfm88: calls $0.06
divindor_dnipro: calls $0.06
*** FLOP *** [9s 2s 8h]
divindor_dnipro: checks 
Lorpugo: bets $0.15
alexfm88: calls $0.15
divindor_dnipro: calls $0.15
*** TURN *** [9s 2s 8h] [Ac]
divindor_dnipro: checks 
Lorpugo: checks 
alexfm88: bets $0.08
divindor_dnipro: calls $0.08
Lorpugo: raises $0.22 to $0.30
alexfm88: calls $0.22
divindor_dnipro: calls $0.22
*** RIVER *** [9s 2s 8h Ac] [8c]
divindor_dnipro: checks 
Lorpugo: bets $0.64 and is all-in
alexfm88: calls $0.64
divindor_dnipro: folds 
*** SHOW DOWN ***
Lorpugo: shows [Qh Jh] (a pair of Eights)
alexfm88: shows [6d 6s] (two pair, Eights and Sixes)
alexfm88 collected $2.77 from pot
*** SUMMARY ***
Total pot $2.87 | Rake $0.10 
Board [9s 2s 8h Ac 8c]
Seat 1: alexfm88 (button) showed [6d 6s] and won ($2.77) with two pair, Eights and Sixes
Seat 3: divindor_dnipro (small blind) folded on the River
Seat 4: Lorpugo (big blind) showed [Qh Jh] and lost with a pair of Eights
Seat 5: frlef65 folded before Flop (didn't bet)



PokerStars Hand #240822785543:  Hold'em No Limit ($0.01/$0.02 USD) - 2022/12/31 13:49:40 ET
Table 'Markab III' 6-max Seat #5 is the button
Seat 1: alexfm88 ($5.10 in chips) 
Seat 3: divindor_dnipro ($0.29 in chips) 
Seat 4: Lorpugo ($1.60 in chips) 
Seat 5: frlef65 ($2.77 in chips) 
alexfm88: posts small blind $0.01
divindor_dnipro: posts big blind $0.02
Lorpugo: posts small blind $0.01
*** HOLE CARDS ***
Dealt to Lorpugo [8c Qd]
Lorpugo: raises $0.04 to $0.06
frlef65: calls $0.06
alexfm88: calls $0.05
divindor_dnipro: calls $0.04
*** FLOP *** [7h Ad 4d]
alexfm88: checks 
divindor_dnipro: checks 
Lorpugo: checks 
frlef65: bets $0.12
alexfm88: folds 
divindor_dnipro: folds 
Lorpugo: folds 
Uncalled bet ($0.12) returned to frlef65
frlef65 collected $0.24 from pot
constantin-z02 leaves the table
*** SUMMARY ***
Total pot $0.25 | Rake $0.01 
Board [7h Ad 4d]
Seat 1: alexfm88 (small blind) folded on the Flop
Seat 3: divindor_dnipro (big blind) folded on the Flop
Seat 4: Lorpugo folded on the Flop
Seat 5: frlef65 (button) collected ($0.24)



PokerStars Hand #240822797959:  Hold'em No Limit ($0.01/$0.02 USD) - 2022/12/31 13:50:22 ET
Table 'Markab III' 6-max Seat #1 is the button
Seat 1: alexfm88 ($5.04 in chips) 
Seat 3: divindor_dnipro ($0.23 in chips) 
Seat 4: Lorpugo ($1.53 in chips) 
Seat 5: frlef65 ($2.95 in chips) 
divindor_dnipro: posts small blind $0.01
Lorpugo: posts big blind $0.02
*** HOLE CARDS ***
Dealt to Lorpugo [4c 3h]
deck_pokemon joins the table at seat #2 
frlef65: calls $0.02
alexfm88: calls $0.02
divindor_dnipro: calls $0.01
Lorpugo: checks 
*** FLOP *** [Kh 7d Ah]
divindor_dnipro: checks 
Lorpugo: checks 
frlef65: bets $0.04
alexfm88: folds 
divindor_dnipro: folds 
Lorpugo: folds 
Uncalled bet ($0.04) returned to frlef65
frlef65 collected $0.08 from pot
*** SUMMARY ***
Total pot $0.08 | Rake $0 
Board [Kh 7d Ah]
Seat 1: alexfm88 (button) folded on the Flop
Seat 3: divindor_dnipro (small blind) folded on the Flop
Seat 4: Lorpugo (big blind) folded on the Flop
Seat 5: frlef65 collected ($0.08)



PokerStars Hand #240822809003:  Hold'em No Limit ($0.01/$0.02 USD) - 2022/12/31 13:51:00 ET
Table 'Markab III' 6-max Seat #3 is the button
Seat 1: alexfm88 ($5.02 in chips) 
Seat 3: divindor_dnipro ($0.21 in chips) 
Seat 4: Lorpugo ($1.51 in chips) 
Seat 5: frlef65 ($3.01 in chips) 
Lorpugo: posts small blind $0.01
frlef65: posts big blind $0.02
*** HOLE CARDS ***
Dealt to Lorpugo [9c Ah]
alexfm88: calls $0.02
divindor_dnipro: raises $0.04 to $0.06
Lorpugo: calls $0.05
frlef65: folds 
alexfm88: calls $0.04
*** FLOP *** [Jc Jh 4h]
Lorpugo: bets $0.06
alexfm88: folds 
divindor_dnipro: raises $0.09 to $0.15 and is all-in
Lorpugo: folds 
Uncalled bet ($0.09) returned to divindor_dnipro
divindor_dnipro collected $0.31 from pot
divindor_dnipro: doesn't show hand 
*** SUMMARY ***
Total pot $0.32 | Rake $0.01 
Board [Jc Jh 4h]
Seat 1: alexfm88 folded on the Flop
Seat 3: divindor_dnipro (button) collected ($0.31)
Seat 4: Lorpugo (small blind) folded on the Flop
Seat 5: frlef65 (big blind) folded before Flop



PokerStars Hand #240822817491:  Hold'em No Limit ($0.01/$0.02 USD) - 2022/12/31 13:51:29 ET
Table 'Markab III' 6-max Seat #4 is the button
Seat 1: alexfm88 ($4.96 in chips) 
Seat 3: divindor_dnipro ($0.40 in chips) 
Seat 4: Lorpugo ($1.39 in chips) 
Seat 5: frlef65 ($2.99 in chips) 
frlef65: posts small blind $0.01
alexfm88: posts big blind $0.02
*** HOLE CARDS ***
Dealt to Lorpugo [Ah 7h]
divindor_dnipro: folds 
Lorpugo: raises $0.04 to $0.06
frlef65: folds 
alexfm88: calls $0.04
*** FLOP *** [7d 8s Qc]
alexfm88: checks 
Lorpugo: bets $0.07
alexfm88: folds 
Uncalled bet ($0.07) returned to Lorpugo
Lorpugo collected $0.13 from pot
Kléber280 leaves the table
Lorpugo: doesn't show hand 
*** SUMMARY ***
Total pot $0.13 | Rake $0 
Board [7d 8s Qc]
Seat 1: alexfm88 (big blind) folded on the Flop
Seat 3: divindor_dnipro folded before Flop (didn't bet)
Seat 4: Lorpugo (button) collected ($0.13)
Seat 5: frlef65 (small blind) folded before Flop



PokerStars Hand #240822823165:  Hold'em No Limit ($0.01/$0.02 USD) - 2022/12/31 13:51:49 ET
Table 'Markab III' 6-max Seat #5 is the button
Seat 1: alexfm88 ($4.90 in chips) 
Seat 2: deck_pokemon ($2 in chips) 
Seat 3: divindor_dnipro ($0.40 in chips) 
Seat 4: Lorpugo ($1.46 in chips) 
Seat 5: frlef65 ($2.98 in chips) 
alexfm88: posts small blind $0.01
deck_pokemon: posts big blind $0.02
*** HOLE CARDS ***
Dealt to Lorpugo [3h Jh]
divindor_dnipro: folds 
Lorpugo: folds 
frlef65: calls $0.02
alexfm88: calls $0.01
deck_pokemon: checks 
*** FLOP *** [8d 2d 7d]
alexfm88: bets $0.02
deck_pokemon: folds 
NightmareBV24 joins the table at seat #6 
frlef65: raises $0.05 to $0.07
alexfm88: calls $0.05
*** TURN *** [8d 2d 7d] [7h]
alexfm88: bets $0.02
frlef65: raises $0.12 to $0.14
alexfm88: raises $0.16 to $0.30
frlef65: calls $0.16
*** RIVER *** [8d 2d 7d 7h] [6h]
alexfm88: bets $0.02
frlef65: raises $0.81 to $0.83
alexfm88: calls $0.81
*** SHOW DOWN ***
frlef65: shows [4h 5d] (a straight, Four to Eight)
alexfm88: mucks hand 
frlef65 collected $2.37 from pot
*** SUMMARY ***
Total pot $2.46 | Rake $0.09 
Board [8d 2d 7d 7h 6h]
Seat 1: alexfm88 (small blind) mucked [Kd Ks]
Seat 2: deck_pokemon (big blind) folded on the Flop
Seat 3: divindor_dnipro folded before Flop (didn't bet)
Seat 4: Lorpugo folded before Flop (didn't bet)
Seat 5: frlef65 (button) showed [4h 5d] and won ($2.37) with a straight, Four to Eight



PokerStars Hand #240822839232:  Hold'em No Limit ($0.01/$0.02 USD) - 2022/12/31 13:52:44 ET
Table 'Markab III' 6-max Seat #1 is the button
Seat 1: alexfm88 ($3.68 in chips) 
Seat 2: deck_pokemon ($2 in chips) 
Seat 3: divindor_dnipro ($0.40 in chips) 
Seat 4: Lorpugo ($1.46 in chips) 
Seat 5: frlef65 ($4.13 in chips) 
deck_pokemon: posts small blind $0.01
divindor_dnipro: posts big blind $0.02
*** HOLE CARDS ***
Dealt to Lorpugo [Jh 9c]
Lorpugo: folds 
frlef65: folds 
alexfm88: calls $0.02
deck_pokemon: raises $0.04 to $0.06
divindor_dnipro: folds 
alexfm88: calls $0.04
*** FLOP *** [Qh 2h Tc]
deck_pokemon: bets $0.04
alexfm88: calls $0.04
*** TURN *** [Qh 2h Tc] [As]
deck_pokemon: checks 
alexfm88: bets $0.04
deck_pokemon: folds 
Uncalled bet ($0.04) returned to alexfm88
alexfm88 collected $0.21 from pot
*** SUMMARY ***
Total pot $0.22 | Rake $0.01 
Board [Qh 2h Tc As]
Seat 1: alexfm88 (button) collected ($0.21)
Seat 2: deck_pokemon (small blind) folded on the Turn
Seat 3: divindor_dnipro (big blind) folded before Flop
Seat 4: Lorpugo folded before Flop (didn't bet)
Seat 5: frlef65 folded before Flop (didn't bet)



PokerStars Hand #240822847870:  Hold'em No Limit ($0.01/$0.02 USD) - 2022/12/31 13:53:13 ET
Table 'Markab III' 6-max Seat #2 is the button
Seat 1: alexfm88 ($3.79 in chips) 
Seat 2: deck_pokemon ($2 in chips) 
Seat 3: divindor_dnipro ($0.38 in chips) 
Seat 4: Lorpugo ($1.46 in chips) 
Seat 5: frlef65 ($4.13 in chips) 
divindor_dnipro: posts small blind $0.01
Lorpugo: posts big blind $0.02
*** HOLE CARDS ***
Dealt to Lorpugo [3d 6h]
frlef65: folds 
alexfm88: calls $0.02
deck_pokemon: raises $0.08 to $0.10
divindor_dnipro: folds 
Lorpugo: folds 
alexfm88: folds 
Uncalled bet ($0.08) returned to deck_pokemon
deck_pokemon collected $0.07 from pot
deck_pokemon: doesn't show hand 
*** SUMMARY ***
Total pot $0.07 | Rake $0 
Seat 1: alexfm88 folded before Flop
Seat 2: deck_pokemon (button) collected ($0.07)
Seat 3: divindor_dnipro (small blind) folded before Flop
Seat 4: Lorpugo (big blind) folded before Flop
Seat 5: frlef65 folded before Flop (didn't bet)



PokerStars Hand #240822855108:  Hold'em No Limit ($0.01/$0.02 USD) - 2022/12/31 13:53:39 ET
Table 'Markab III' 6-max Seat #3 is the button
Seat 1: alexfm88 ($3.77 in chips) 
Seat 2: deck_pokemon ($2.05 in chips) 
Seat 3: divindor_dnipro ($0.37 in chips) 
Seat 4: Lorpugo ($1.44 in chips) 
Seat 5: frlef65 ($4.13 in chips) 
Lorpugo: posts small blind $0.01
frlef65: posts big blind $0.02
*** HOLE CARDS ***
Dealt to Lorpugo [8d 5c]
alexfm88: calls $0.02
deck_pokemon: folds 
divindor_dnipro: calls $0.02
Lorpugo: folds 
frlef65: checks 
*** FLOP *** [2s 7d Ad]
frlef65: bets $0.02
alexfm88: calls $0.02
divindor_dnipro: calls $0.02
*** TURN *** [2s 7d Ad] [5s]
frlef65: bets $0.07
alexfm88: folds 
divindor_dnipro: calls $0.07
*** RIVER *** [2s 7d Ad 5s] [8h]
frlef65: bets $0.13
divindor_dnipro: folds 
Uncalled bet ($0.13) returned to frlef65
frlef65 collected $0.26 from pot
*** SUMMARY ***
Total pot $0.27 | Rake $0.01 
Board [2s 7d Ad 5s 8h]
Seat 1: alexfm88 folded on the Turn
Seat 2: deck_pokemon folded before Flop (didn't bet)
Seat 3: divindor_dnipro (button) folded on the River
Seat 4: Lorpugo (small blind) folded before Flop
Seat 5: frlef65 (big blind) collected ($0.26)



PokerStars Hand #240822864224:  Hold'em No Limit ($0.01/$0.02 USD) - 2022/12/31 13:54:10 ET
Table 'Markab III' 6-max Seat #4 is the button
Seat 1: alexfm88 ($3.73 in chips) 
Seat 2: deck_pokemon ($2.05 in chips) 
Seat 3: divindor_dnipro ($0.26 in chips) 
Seat 4: Lorpugo ($1.43 in chips) 
Seat 5: frlef65 ($4.28 in chips) 
Seat 6: NightmareBV24 ($2 in chips) 
frlef65: posts small blind $0.01
NightmareBV24: posts big blind $0.02
*** HOLE CARDS ***
Dealt to Lorpugo [Qd 6d]
alexfm88: raises $0.02 to $0.04
deck_pokemon: folds 
divindor_dnipro: folds 
Lorpugo: folds 
frlef65: folds 
NightmareBV24: folds 
Uncalled bet ($0.02) returned to alexfm88
alexfm88 collected $0.05 from pot
*** SUMMARY ***
Total pot $0.05 | Rake $0 
Seat 1: alexfm88 collected ($0.05)
Seat 2: deck_pokemon folded before Flop (didn't bet)
Seat 3: divindor_dnipro folded before Flop (didn't bet)
Seat 4: Lorpugo (button) folded before Flop (didn't bet)
Seat 5: frlef65 (small blind) folded before Flop
Seat 6: NightmareBV24 (big blind) folded before Flop



PokerStars Hand #240822871172:  Hold'em No Limit ($0.01/$0.02 USD) - 2022/12/31 13:54:35 ET
Table 'Markab III' 6-max Seat #5 is the button
Seat 1: alexfm88 ($3.76 in chips) 
Seat 2: deck_pokemon ($2.05 in chips) 
Seat 3: divindor_dnipro ($0.26 in chips) 
Seat 4: Lorpugo ($1.43 in chips) 
Seat 5: frlef65 ($4.27 in chips) 
Seat 6: NightmareBV24 ($2 in chips) 
NightmareBV24: posts small blind $0.01
alexfm88: posts big blind $0.02
*** HOLE CARDS ***
Dealt to Lorpugo [8d 7s]
deck_pokemon: folds 
divindor_dnipro: folds 
Lorpugo: raises $0.04 to $0.06
frlef65: calls $0.06
NightmareBV24: folds 
alexfm88: calls $0.04
*** FLOP *** [2h 5h 3c]
alexfm88: checks 
Lorpugo: checks 
frlef65: checks 
*** TURN *** [2h 5h 3c] [4h]
alexfm88: bets $0.02
Lorpugo: folds 
frlef65: raises $0.11 to $0.13
alexfm88: calls $0.11
*** RIVER *** [2h 5h 3c 4h] [3h]
alexfm88: checks 
frlef65: bets $0.43
alexfm88: calls $0.43
*** SHOW DOWN ***
frlef65: shows [4d As] (a straight, Ace to Five)
alexfm88: shows [Ac Jh] (a flush, Jack high)
alexfm88 collected $1.26 from pot
*** SUMMARY ***
Total pot $1.31 | Rake $0.05 
Board [2h 5h 3c 4h 3h]
Seat 1: alexfm88 (big blind) showed [Ac Jh] and won ($1.26) with a flush, Jack high
Seat 2: deck_pokemon folded before Flop (didn't bet)
Seat 3: divindor_dnipro folded before Flop (didn't bet)
Seat 4: Lorpugo folded on the Turn
Seat 5: frlef65 (button) showed [4d As] and lost with a straight, Ace to Five
Seat 6: NightmareBV24 (small blind) folded before Flop



PokerStars Hand #240822884257:  Hold'em No Limit ($0.01/$0.02 USD) - 2022/12/31 13:55:23 ET
Table 'Markab III' 6-max Seat #6 is the button
Seat 1: alexfm88 ($4.40 in chips) 
Seat 2: deck_pokemon ($2.05 in chips) 
Seat 3: divindor_dnipro ($0.26 in chips) 
Seat 4: Lorpugo ($1.37 in chips) 
Seat 5: frlef65 ($3.65 in chips) 
Seat 6: NightmareBV24 ($2 in chips) 
alexfm88: posts small blind $0.01
deck_pokemon: posts big blind $0.02
*** HOLE CARDS ***
Dealt to Lorpugo [Ah Kh]
divindor_dnipro: folds 
Lorpugo: raises $0.04 to $0.06
frlef65: calls $0.06
NightmareBV24: folds 
alexfm88: calls $0.05
deck_pokemon: folds 
*** FLOP *** [Jh 3c 7c]
alexfm88: bets $0.02
Lorpugo: calls $0.02
frlef65: calls $0.02
*** TURN *** [Jh 3c 7c] [9h]
alexfm88: checks 
Lorpugo: checks 
frlef65: bets $0.25
alexfm88: folds 
Lorpugo: calls $0.25
*** RIVER *** [Jh 3c 7c 9h] [Qs]
Lorpugo: checks 
frlef65: bets $0.37
Lorpugo: raises $0.67 to $1.04 and is all-in
frlef65: folds 
Uncalled bet ($0.67) returned to Lorpugo
Lorpugo collected $1.45 from pot
Lorpugo: doesn't show hand 
*** SUMMARY ***
Total pot $1.50 | Rake $0.05 
Board [Jh 3c 7c 9h Qs]
Seat 1: alexfm88 (small blind) folded on the Turn
Seat 2: deck_pokemon (big blind) folded before Flop
Seat 3: divindor_dnipro folded before Flop (didn't bet)
Seat 4: Lorpugo collected ($1.45)
Seat 5: frlef65 folded on the River
Seat 6: NightmareBV24 (button) folded before Flop (didn't bet)



PokerStars Hand #240822895715:  Hold'em No Limit ($0.01/$0.02 USD) - 2022/12/31 13:56:18 ET
Table 'Markab III' 6-max Seat #1 is the button
Seat 1: alexfm88 ($4.32 in chips) 
Seat 2: deck_pokemon ($2.03 in chips) 
Seat 3: divindor_dnipro ($0.26 in chips) 
Seat 4: Lorpugo ($2.12 in chips) 
Seat 5: frlef65 ($2.95 in chips) 
Seat 6: NightmareBV24 ($2 in chips) 
deck_pokemon: posts small blind $0.01
divindor_dnipro: posts big blind $0.02
*** HOLE CARDS ***
Dealt to Lorpugo [7s Jc]
Lorpugo: folds 
frlef65: folds 
NightmareBV24: folds 
alexfm88: calls $0.02
deck_pokemon: folds 
divindor_dnipro: checks 
*** FLOP *** [7d As Qs]
divindor_dnipro: checks 
alexfm88: bets $0.02
divindor_dnipro: folds 
Uncalled bet ($0.02) returned to alexfm88
alexfm88 collected $0.05 from pot
*** SUMMARY ***
Total pot $0.05 | Rake $0 
Board [7d As Qs]
Seat 1: alexfm88 (button) collected ($0.05)
Seat 2: deck_pokemon (small blind) folded before Flop
Seat 3: divindor_dnipro (big blind) folded on the Flop
Seat 4: Lorpugo folded before Flop (didn't bet)
Seat 5: frlef65 folded before Flop (didn't bet)
Seat 6: NightmareBV24 folded before Flop (didn't bet)



PokerStars Hand #240822902236:  Hold'em No Limit ($0.01/$0.02 USD) - 2022/12/31 13:56:49 ET
Table 'Markab III' 6-max Seat #2 is the button
Seat 1: alexfm88 ($4.35 in chips) 
Seat 2: deck_pokemon ($2.02 in chips) 
Seat 3: divindor_dnipro ($0.24 in chips) 
Seat 4: Lorpugo ($2.12 in chips) 
Seat 5: frlef65 ($2.95 in chips) 
Seat 6: NightmareBV24 ($2 in chips) 
divindor_dnipro: posts small blind $0.01
Lorpugo: posts big blind $0.02
*** HOLE CARDS ***
Dealt to Lorpugo [Qc 8s]
frlef65: folds 
NightmareBV24: folds 
alexfm88: calls $0.02
deck_pokemon: folds 
divindor_dnipro: calls $0.01
Lorpugo: checks 
*** FLOP *** [9s Qh Qs]
divindor_dnipro: checks 
Lorpugo: checks 
alexfm88: bets $0.02
divindor_dnipro: folds 
Lorpugo: raises $0.05 to $0.07
alexfm88: calls $0.05
*** TURN *** [9s Qh Qs] [5c]
Lorpugo: bets $0.13
alexfm88: calls $0.13
*** RIVER *** [9s Qh Qs 5c] [5d]
Lorpugo: bets $0.68
alexfm88: calls $0.68
*** SHOW DOWN ***
Lorpugo: shows [Qc 8s] (a full house, Queens full of Fives)
alexfm88: mucks hand 
Lorpugo collected $1.76 from pot
*** SUMMARY ***
Total pot $1.82 | Rake $0.06 
Board [9s Qh Qs 5c 5d]
Seat 1: alexfm88 mucked [Ac 3d]
Seat 2: deck_pokemon (button) folded before Flop (didn't bet)
Seat 3: divindor_dnipro (small blind) folded on the Flop
Seat 4: Lorpugo (big blind) showed [Qc 8s] and won ($1.76) with a full house, Queens full of Fives
Seat 5: frlef65 folded before Flop (didn't bet)
Seat 6: NightmareBV24 folded before Flop (didn't bet)



PokerStars Hand #240822913524:  Hold'em No Limit ($0.01/$0.02 USD) - 2022/12/31 13:57:42 ET
Table 'Markab III' 6-max Seat #3 is the button
Seat 1: alexfm88 ($3.45 in chips) 
Seat 2: deck_pokemon ($2.02 in chips) 
Seat 3: divindor_dnipro ($0.22 in chips) 
Seat 4: Lorpugo ($2.98 in chips) 
Seat 5: frlef65 ($2.95 in chips) 
Seat 6: NightmareBV24 ($2 in chips) 
Lorpugo: posts small blind $0.01
frlef65: posts big blind $0.02
*** HOLE CARDS ***
Dealt to Lorpugo [6d Ac]
NightmareBV24: folds 
alexfm88: calls $0.02
deck_pokemon: folds 
divindor_dnipro: folds 
Lorpugo: calls $0.01
frlef65: checks 
*** FLOP *** [3s 3d Ad]
Lorpugo: checks 
frlef65: bets $0.02
alexfm88: folds 
Lorpugo: calls $0.02
*** TURN *** [3s 3d Ad] [5c]
Lorpugo: checks 
frlef65: bets $0.10
Lorpugo: calls $0.10
*** RIVER *** [3s 3d Ad 5c] [8d]
Lorpugo: checks 
frlef65: bets $0.51
Lorpugo: folds 
Uncalled bet ($0.51) returned to frlef65
frlef65 collected $0.29 from pot
*** SUMMARY ***
Total pot $0.30 | Rake $0.01 
Board [3s 3d Ad 5c 8d]
Seat 1: alexfm88 folded on the Flop
Seat 2: deck_pokemon folded before Flop (didn't bet)
Seat 3: divindor_dnipro (button) folded before Flop (didn't bet)
Seat 4: Lorpugo (small blind) folded on the River
Seat 5: frlef65 (big blind) collected ($0.29)
Seat 6: NightmareBV24 folded before Flop (didn't bet)



PokerStars Hand #240822925915:  Hold'em No Limit ($0.01/$0.02 USD) - 2022/12/31 13:58:41 ET
Table 'Markab III' 6-max Seat #4 is the button
Seat 1: alexfm88 ($3.43 in chips) 
Seat 2: deck_pokemon ($2.02 in chips) 
Seat 3: divindor_dnipro ($0.22 in chips) 
Seat 4: Lorpugo ($2.84 in chips) 
Seat 5: frlef65 ($3.10 in chips) 
Seat 6: NightmareBV24 ($2 in chips) 
frlef65: posts small blind $0.01
NightmareBV24: posts big blind $0.02
*** HOLE CARDS ***
Dealt to Lorpugo [Ts 5c]
alexfm88: calls $0.02
deck_pokemon: folds 
divindor_dnipro: calls $0.02
Lorpugo: folds 
frlef65: calls $0.01
NightmareBV24: checks 
*** FLOP *** [Qs 6c Td]
frlef65: bets $0.04
NightmareBV24: calls $0.04
alexfm88: calls $0.04
divindor_dnipro: calls $0.04
*** TURN *** [Qs 6c Td] [8h]
frlef65: bets $0.12
NightmareBV24: calls $0.12
alexfm88: folds 
divindor_dnipro: calls $0.12
*** RIVER *** [Qs 6c Td 8h] [3h]
frlef65: bets $0.29
NightmareBV24: calls $0.29
divindor_dnipro: calls $0.04 and is all-in
*** SHOW DOWN ***
frlef65: shows [5h 5d] (a pair of Fives)
NightmareBV24: shows [Qh Jd] (a pair of Queens)
NightmareBV24 collected $0.49 from side pot
divindor_dnipro: mucks hand 
NightmareBV24 collected $0.69 from main pot
*** SUMMARY ***
Total pot $1.22 Main pot $0.69. Side pot $0.49. | Rake $0.04 
Board [Qs 6c Td 8h 3h]
Seat 1: alexfm88 folded on the Turn
Seat 2: deck_pokemon folded before Flop (didn't bet)
Seat 3: divindor_dnipro mucked [Ad Kc]
Seat 4: Lorpugo (button) folded before Flop (didn't bet)
Seat 5: frlef65 (small blind) showed [5h 5d] and lost with a pair of Fives
Seat 6: NightmareBV24 (big blind) showed [Qh Jd] and won ($1.18) with a pair of Queens



PokerStars Hand #240822935612:  Hold'em No Limit ($0.01/$0.02 USD) - 2022/12/31 13:59:27 ET
Table 'Markab III' 6-max Seat #5 is the button
Seat 1: alexfm88 ($3.37 in chips) 
Seat 2: deck_pokemon ($2.02 in chips) 
Seat 4: Lorpugo ($2.84 in chips) 
Seat 5: frlef65 ($2.63 in chips) 
Seat 6: NightmareBV24 ($2.71 in chips) 
NightmareBV24: posts small blind $0.01
alexfm88: posts big blind $0.02
*** HOLE CARDS ***
Dealt to Lorpugo [3c 3h]
divindor_dnipro leaves the table
deck_pokemon: folds 
Lorpugo: raises $0.04 to $0.06
flippinghand joins the table at seat #3 
frlef65: calls $0.06
NightmareBV24: calls $0.05
alexfm88: calls $0.04
*** FLOP *** [Qc Kc As]
NightmareBV24: checks 
alexfm88: checks 
Lorpugo: checks 
frlef65: bets $0.10
NightmareBV24: folds 
alexfm88: calls $0.10
Lorpugo: folds 
*** TURN *** [Qc Kc As] [Jc]
alexfm88: bets $0.02
frlef65: raises $0.08 to $0.10
alexfm88: raises $0.20 to $0.30
frlef65: raises $1.02 to $1.32
alexfm88: raises $1.02 to $2.34
frlef65: calls $1.02
*** RIVER *** [Qc Kc As Jc] [6d]
alexfm88: bets $0.14
frlef65: calls $0.13 and is all-in
Uncalled bet ($0.01) returned to alexfm88
*** SHOW DOWN ***
alexfm88: shows [Td Ts] (a straight, Ten to Ace)
frlef65: shows [Ac 4s] (a pair of Aces)
alexfm88 collected $5.19 from pot
*** SUMMARY ***
Total pot $5.38 | Rake $0.19 
Board [Qc Kc As Jc 6d]
Seat 1: alexfm88 (big blind) showed [Td Ts] and won ($5.19) with a straight, Ten to Ace
Seat 2: deck_pokemon folded before Flop (didn't bet)
Seat 4: Lorpugo folded on the Flop
Seat 5: frlef65 (button) showed [Ac 4s] and lost with a pair of Aces
Seat 6: NightmareBV24 (small blind) folded on the Flop



PokerStars Hand #240822953672:  Hold'em No Limit ($0.01/$0.02 USD) - 2022/12/31 14:00:49 ET
Table 'Markab III' 6-max Seat #6 is the button
Seat 1: alexfm88 ($5.93 in chips) 
Seat 2: deck_pokemon ($2.02 in chips) 
Seat 4: Lorpugo ($2.78 in chips) 
Seat 6: NightmareBV24 ($2.65 in chips) 
alexfm88: posts small blind $0.01
deck_pokemon: posts big blind $0.02
*** HOLE CARDS ***
Dealt to Lorpugo [4c Jc]
Lorpugo: folds 
NightmareBV24: raises $0.03 to $0.05
alexfm88: calls $0.04
deck_pokemon: folds 
*** FLOP *** [Kh 4d 3h]
alexfm88: checks 
NightmareBV24: bets $0.04
alexfm88: folds 
Uncalled bet ($0.04) returned to NightmareBV24
NightmareBV24 collected $0.12 from pot
*** SUMMARY ***
Total pot $0.12 | Rake $0 
Board [Kh 4d 3h]
Seat 1: alexfm88 (small blind) folded on the Flop
Seat 2: deck_pokemon (big blind) folded before Flop
Seat 4: Lorpugo folded before Flop (didn't bet)
Seat 6: NightmareBV24 (button) collected ($0.12)



PokerStars Hand #240822966502:  Hold'em No Limit ($0.01/$0.02 USD) - 2022/12/31 14:01:38 ET
Table 'Markab III' 6-max Seat #1 is the button
Seat 1: alexfm88 ($5.88 in chips) 
Seat 2: deck_pokemon ($2 in chips) 
Seat 3: flippinghand ($2 in chips) 
Seat 4: Lorpugo ($2.78 in chips) 
Seat 5: frlef65 ($2 in chips) 
Seat 6: NightmareBV24 ($2.72 in chips) 
deck_pokemon: posts small blind $0.01
flippinghand: posts big blind $0.02
*** HOLE CARDS ***
Dealt to Lorpugo [6d Ad]
Lorpugo: raises $0.02 to $0.04
frlef65: calls $0.04
NightmareBV24: folds 
alexfm88: calls $0.04
deck_pokemon: folds 
flippinghand: folds 
*** FLOP *** [6s 5h 7s]
Lorpugo: bets $0.02
frlef65: raises $0.05 to $0.07
alexfm88: folds 
Lorpugo: calls $0.05
*** TURN *** [6s 5h 7s] [Td]
alexfm88 is disconnected 
Lorpugo: checks 
frlef65: bets $0.14
Lorpugo: folds 
Uncalled bet ($0.14) returned to frlef65
frlef65 collected $0.28 from pot
*** SUMMARY ***
Total pot $0.29 | Rake $0.01 
Board [6s 5h 7s Td]
Seat 1: alexfm88 (button) folded on the Flop
Seat 2: deck_pokemon (small blind) folded before Flop
Seat 3: flippinghand (big blind) folded before Flop
Seat 4: Lorpugo folded on the Turn
Seat 5: frlef65 collected ($0.28)
Seat 6: NightmareBV24 folded before Flop (didn't bet)



PokerStars Hand #240822977414:  Hold'em No Limit ($0.01/$0.02 USD) - 2022/12/31 14:02:17 ET
Table 'Markab III' 6-max Seat #2 is the button
Seat 1: alexfm88 ($5.84 in chips) 
Seat 2: deck_pokemon ($2 in chips) 
Seat 3: flippinghand ($1.98 in chips) 
Seat 4: Lorpugo ($2.67 in chips) 
Seat 5: frlef65 ($2.17 in chips) 
Seat 6: NightmareBV24 ($2.72 in chips) 
flippinghand: posts small blind $0.01
Lorpugo: posts big blind $0.02
*** HOLE CARDS ***
Dealt to Lorpugo [Td Jc]
frlef65: raises $0.02 to $0.04
NightmareBV24: folds 
alexfm88 has timed out while disconnected
alexfm88: folds 
deck_pokemon: folds 
flippinghand: folds 
Lorpugo: calls $0.02
*** FLOP *** [4d 9d As]
Lorpugo: checks 
frlef65: bets $0.05
Lorpugo: folds 
Uncalled bet ($0.05) returned to frlef65
frlef65 collected $0.09 from pot
*** SUMMARY ***
Total pot $0.09 | Rake $0 
Board [4d 9d As]
Seat 1: alexfm88 folded before Flop (didn't bet)
Seat 2: deck_pokemon (button) folded before Flop (didn't bet)
Seat 3: flippinghand (small blind) folded before Flop
Seat 4: Lorpugo (big blind) folded on the Flop
Seat 5: frlef65 collected ($0.09)
Seat 6: NightmareBV24 folded before Flop (didn't bet)



PokerStars Hand #240822992192:  Hold'em No Limit ($0.01/$0.02 USD) - 2022/12/31 14:03:09 ET
Table 'Markab III' 6-max Seat #3 is the button
Seat 2: deck_pokemon ($2 in chips) 
Seat 3: flippinghand ($2 in chips) 
Seat 4: Lorpugo ($2.63 in chips) 
Seat 5: frlef65 ($2.22 in chips) 
Seat 6: NightmareBV24 ($2.72 in chips) 
Lorpugo: posts small blind $0.01
frlef65: posts big blind $0.02
*** HOLE CARDS ***
Dealt to Lorpugo [4h 6d]
NightmareBV24: folds 
deck_pokemon: folds 
flippinghand: folds 
Lorpugo: raises $0.04 to $0.06
frlef65: folds 
Uncalled bet ($0.04) returned to Lorpugo
Lorpugo collected $0.04 from pot
Lorpugo: doesn't show hand 
*** SUMMARY ***
Total pot $0.04 | Rake $0 
Seat 2: deck_pokemon folded before Flop (didn't bet)
Seat 3: flippinghand (button) folded before Flop (didn't bet)
Seat 4: Lorpugo (small blind) collected ($0.04)
Seat 5: frlef65 (big blind) folded before Flop
Seat 6: NightmareBV24 folded before Flop (didn't bet)



PokerStars Hand #240822997023:  Hold'em No Limit ($0.01/$0.02 USD) - 2022/12/31 14:03:26 ET
Table 'Markab III' 6-max Seat #4 is the button
Seat 2: deck_pokemon ($2 in chips) 
Seat 3: flippinghand ($2 in chips) 
Seat 4: Lorpugo ($2.65 in chips) 
Seat 5: frlef65 ($2.20 in chips) 
Seat 6: NightmareBV24 ($2.72 in chips) 
frlef65: posts small blind $0.01
NightmareBV24: posts big blind $0.02
*** HOLE CARDS ***
Dealt to Lorpugo [2h Ks]
deck_pokemon: folds 
flippinghand: folds 
Lorpugo: folds 
frlef65: calls $0.01
NightmareBV24: checks 
*** FLOP *** [4h 9d 7c]
frlef65: bets $0.02
NightmareBV24: folds 
Uncalled bet ($0.02) returned to frlef65
NightmareBV24 leaves the table
frlef65 collected $0.04 from pot
*** SUMMARY ***
Total pot $0.04 | Rake $0 
Board [4h 9d 7c]
Seat 2: deck_pokemon folded before Flop (didn't bet)
Seat 3: flippinghand folded before Flop (didn't bet)
Seat 4: Lorpugo (button) folded before Flop (didn't bet)
Seat 5: frlef65 (small blind) collected ($0.04)
Seat 6: NightmareBV24 (big blind) folded on the Flop



PokerStars Hand #240823004909:  Hold'em No Limit ($0.01/$0.02 USD) - 2022/12/31 14:03:53 ET
Table 'Markab III' 6-max Seat #5 is the button
Seat 2: deck_pokemon ($2 in chips) 
Seat 3: flippinghand ($2 in chips) 
Seat 4: Lorpugo ($2.65 in chips) 
Seat 5: frlef65 ($2.22 in chips) 
deck_pokemon: posts small blind $0.01
flippinghand: posts big blind $0.02
*** HOLE CARDS ***
Dealt to Lorpugo [8h 4h]
Lorpugo: folds 
frlef65: folds 
deck_pokemon: folds 
Uncalled bet ($0.01) returned to flippinghand
flippinghand collected $0.02 from pot
flippinghand: doesn't show hand 
*** SUMMARY ***
Total pot $0.02 | Rake $0 
Seat 2: deck_pokemon (small blind) folded before Flop
Seat 3: flippinghand (big blind) collected ($0.02)
Seat 4: Lorpugo folded before Flop (didn't bet)
Seat 5: frlef65 (button) folded before Flop (didn't bet)



PokerStars Hand #240823007792:  Hold'em No Limit ($0.01/$0.02 USD) - 2022/12/31 14:04:03 ET
Table 'Markab III' 6-max Seat #2 is the button
Seat 2: deck_pokemon ($2 in chips) 
Seat 3: flippinghand ($2.01 in chips) 
Seat 4: Lorpugo ($2.65 in chips) 
Seat 5: frlef65 ($2.22 in chips) 
flippinghand: posts small blind $0.01
Lorpugo: posts big blind $0.02
*** HOLE CARDS ***
Dealt to Lorpugo [3c Jc]
josedf7509 joins the table at seat #6 
frlef65: folds 
deck_pokemon: folds 
flippinghand: raises $0.04 to $0.06
Lorpugo: calls $0.04
*** FLOP *** [Ks 5h 5c]
flippinghand: bets $0.06
Lorpugo: raises $0.12 to $0.18
flippinghand: folds 
Uncalled bet ($0.12) returned to Lorpugo
Lorpugo collected $0.23 from pot
Lorpugo: doesn't show hand 
*** SUMMARY ***
Total pot $0.24 | Rake $0.01 
Board [Ks 5h 5c]
Seat 2: deck_pokemon (button) folded before Flop (didn't bet)
Seat 3: flippinghand (small blind) folded on the Flop
Seat 4: Lorpugo (big blind) collected ($0.23)
Seat 5: frlef65 folded before Flop (didn't bet)



PokerStars Hand #240823020159:  Hold'em No Limit ($0.01/$0.02 USD) - 2022/12/31 14:04:46 ET
Table 'Markab III' 6-max Seat #3 is the button
Seat 2: deck_pokemon ($2 in chips) 
Seat 3: flippinghand ($2 in chips) 
Seat 4: Lorpugo ($2.76 in chips) 
Seat 5: frlef65 ($2.22 in chips) 
Lorpugo: posts small blind $0.01
frlef65: posts big blind $0.02
*** HOLE CARDS ***
Dealt to Lorpugo [8d Jh]
deck_pokemon: folds 
flippinghand: folds 
Lorpugo: raises $0.04 to $0.06
frlef65: calls $0.04
*** FLOP *** [Qc Jc 2c]
Lorpugo: checks 
frlef65: checks 
*** TURN *** [Qc Jc 2c] [Td]
Lorpugo: bets $0.06
frlef65: folds 
Uncalled bet ($0.06) returned to Lorpugo
Lorpugo collected $0.12 from pot
Lorpugo: doesn't show hand 
*** SUMMARY ***
Total pot $0.12 | Rake $0 
Board [Qc Jc 2c Td]
Seat 2: deck_pokemon folded before Flop (didn't bet)
Seat 3: flippinghand (button) folded before Flop (didn't bet)
Seat 4: Lorpugo (small blind) collected ($0.12)
Seat 5: frlef65 (big blind) folded on the Turn



PokerStars Hand #240823028219:  Hold'em No Limit ($0.01/$0.02 USD) - 2022/12/31 14:05:14 ET
Table 'Markab III' 6-max Seat #4 is the button
Seat 2: deck_pokemon ($2 in chips) 
Seat 3: flippinghand ($2 in chips) 
Seat 4: Lorpugo ($2.82 in chips) 
Seat 5: frlef65 ($2.16 in chips) 
Seat 6: josedf7509 ($2 in chips) 
frlef65: posts small blind $0.01
josedf7509: posts big blind $0.02
*** HOLE CARDS ***
Dealt to Lorpugo [4s 5d]
deck_pokemon: folds 
flippinghand: folds 
Lorpugo: raises $0.04 to $0.06
frlef65: calls $0.05
josedf7509: folds 
*** FLOP *** [3d Jh Ts]
frlef65: bets $0.07
Lorpugo: folds 
Uncalled bet ($0.07) returned to frlef65
frlef65 collected $0.14 from pot
*** SUMMARY ***
Total pot $0.14 | Rake $0 
Board [3d Jh Ts]
Seat 2: deck_pokemon folded before Flop (didn't bet)
Seat 3: flippinghand folded before Flop (didn't bet)
Seat 4: Lorpugo (button) folded on the Flop
Seat 5: frlef65 (small blind) collected ($0.14)
Seat 6: josedf7509 (big blind) folded before Flop



PokerStars Hand #240823035867:  Hold'em No Limit ($0.01/$0.02 USD) - 2022/12/31 14:05:41 ET
Table 'Markab III' 6-max Seat #5 is the button
Seat 2: deck_pokemon ($2 in chips) 
Seat 3: flippinghand ($2 in chips) 
Seat 4: Lorpugo ($2.76 in chips) 
Seat 5: frlef65 ($2.24 in chips) 
Seat 6: josedf7509 ($2 in chips) 
josedf7509: posts small blind $0.01
deck_pokemon: posts big blind $0.02
*** HOLE CARDS ***
Dealt to Lorpugo [Qs 2h]
flippinghand: folds 
Lorpugo: folds 
frlef65: calls $0.02
josedf7509: folds 
deck_pokemon: checks 
*** FLOP *** [4s Ks Ah]
deck_pokemon: checks 
frlef65: bets $0.03
deck_pokemon: folds 
Uncalled bet ($0.03) returned to frlef65
frlef65 collected $0.05 from pot
*** SUMMARY ***
Total pot $0.05 | Rake $0 
Board [4s Ks Ah]
Seat 2: deck_pokemon (big blind) folded on the Flop
Seat 3: flippinghand folded before Flop (didn't bet)
Seat 4: Lorpugo folded before Flop (didn't bet)
Seat 5: frlef65 (button) collected ($0.05)
Seat 6: josedf7509 (small blind) folded before Flop



PokerStars Hand #240823043136:  Hold'em No Limit ($0.01/$0.02 USD) - 2022/12/31 14:06:06 ET
Table 'Markab III' 6-max Seat #6 is the button
Seat 2: deck_pokemon ($2 in chips) 
Seat 3: flippinghand ($2 in chips) 
Seat 4: Lorpugo ($2.76 in chips) 
Seat 5: frlef65 ($2.27 in chips) 
Seat 6: josedf7509 ($2 in chips) 
deck_pokemon: posts small blind $0.01
flippinghand: posts big blind $0.02
*** HOLE CARDS ***
Dealt to Lorpugo [8h Kh]
Lorpugo: folds 
frlef65: calls $0.02
josedf7509: folds 
josedf7509 leaves the table
deck_pokemon: raises $0.04 to $0.06
flippinghand: folds 
frlef65: calls $0.04
*** FLOP *** [6h 5c 2d]
deck_pokemon: bets $0.04
frlef65: raises $0.22 to $0.26
deck_pokemon: folds 
Uncalled bet ($0.22) returned to frlef65
frlef65 collected $0.21 from pot
*** SUMMARY ***
Total pot $0.22 | Rake $0.01 
Board [6h 5c 2d]
Seat 2: deck_pokemon (small blind) folded on the Flop
Seat 3: flippinghand (big blind) folded before Flop
Seat 4: Lorpugo folded before Flop (didn't bet)
Seat 5: frlef65 collected ($0.21)
Seat 6: josedf7509 (button) folded before Flop (didn't bet)



PokerStars Hand #240823055561:  Hold'em No Limit ($0.01/$0.02 USD) - 2022/12/31 14:06:49 ET
Table 'Markab III' 6-max Seat #2 is the button
Seat 2: deck_pokemon ($2 in chips) 
Seat 3: flippinghand ($1.98 in chips) 
Seat 4: Lorpugo ($2.76 in chips) 
Seat 5: frlef65 ($2.38 in chips) 
flippinghand: posts small blind $0.01
Lorpugo: posts big blind $0.02
*** HOLE CARDS ***
Dealt to Lorpugo [Qh 6d]
frlef65: calls $0.02
deck_pokemon: raises $0.08 to $0.10
flippinghand: folds 
Lorpugo: folds 
frlef65: folds 
Uncalled bet ($0.08) returned to deck_pokemon
deck_pokemon collected $0.07 from pot
deck_pokemon: doesn't show hand 
*** SUMMARY ***
Total pot $0.07 | Rake $0 
Seat 2: deck_pokemon (button) collected ($0.07)
Seat 3: flippinghand (small blind) folded before Flop
Seat 4: Lorpugo (big blind) folded before Flop
Seat 5: frlef65 folded before Flop



PokerStars Hand #240823059475:  Hold'em No Limit ($0.01/$0.02 USD) - 2022/12/31 14:07:03 ET
Table 'Markab III' 6-max Seat #3 is the button
Seat 2: deck_pokemon ($2.05 in chips) 
Seat 3: flippinghand ($2 in chips) 
Seat 4: Lorpugo ($2.74 in chips) 
Seat 5: frlef65 ($2.36 in chips) 
Lorpugo: posts small blind $0.01
frlef65: posts big blind $0.02
*** HOLE CARDS ***
Dealt to Lorpugo [5d 5s]
deck_pokemon: folds 
flippinghand: folds 
Lorpugo: raises $0.04 to $0.06
frlef65: folds 
Uncalled bet ($0.04) returned to Lorpugo
Lorpugo collected $0.04 from pot
Lorpugo: doesn't show hand 
*** SUMMARY ***
Total pot $0.04 | Rake $0 
Seat 2: deck_pokemon folded before Flop (didn't bet)
Seat 3: flippinghand (button) folded before Flop (didn't bet)
Seat 4: Lorpugo (small blind) collected ($0.04)
Seat 5: frlef65 (big blind) folded before Flop



PokerStars Hand #240823062848:  Hold'em No Limit ($0.01/$0.02 USD) - 2022/12/31 14:07:15 ET
Table 'Markab III' 6-max Seat #4 is the button
Seat 2: deck_pokemon ($2.05 in chips) 
Seat 3: flippinghand ($2 in chips) 
Seat 4: Lorpugo ($2.76 in chips) 
Seat 5: frlef65 ($2.34 in chips) 
frlef65: posts small blind $0.01
deck_pokemon: posts big blind $0.02
*** HOLE CARDS ***
Dealt to Lorpugo [6h 3h]
flippinghand: raises $0.05 to $0.07
Lorpugo: folds 
frlef65: folds 
deck_pokemon: folds 
Uncalled bet ($0.05) returned to flippinghand
flippinghand collected $0.05 from pot
flippinghand: doesn't show hand 
*** SUMMARY ***
Total pot $0.05 | Rake $0 
Seat 2: deck_pokemon (big blind) folded before Flop
Seat 3: flippinghand collected ($0.05)
Seat 4: Lorpugo (button) folded before Flop (didn't bet)
Seat 5: frlef65 (small blind) folded before Flop



PokerStars Hand #240823069102:  Hold'em No Limit ($0.01/$0.02 USD) - 2022/12/31 14:07:37 ET
Table 'Markab III' 6-max Seat #5 is the button
Seat 2: deck_pokemon ($2.03 in chips) 
Seat 3: flippinghand ($2.03 in chips) 
Seat 4: Lorpugo ($2.76 in chips) 
Seat 5: frlef65 ($2.33 in chips) 
deck_pokemon: posts small blind $0.01
flippinghand: posts big blind $0.02
*** HOLE CARDS ***
Dealt to Lorpugo [4s 7c]
Lorpugo: folds 
frlef65: raises $0.02 to $0.04
deck_pokemon: calls $0.03
cartani1980 joins the table at seat #6 
flippinghand: folds 
*** FLOP *** [2d 6h 9c]
deck_pokemon: checks 
frlef65: bets $0.10
deck_pokemon: folds 
Uncalled bet ($0.10) returned to frlef65
frlef65 collected $0.10 from pot
*** SUMMARY ***
Total pot $0.10 | Rake $0 
Board [2d 6h 9c]
Seat 2: deck_pokemon (small blind) folded on the Flop
Seat 3: flippinghand (big blind) folded before Flop
Seat 4: Lorpugo folded before Flop (didn't bet)
Seat 5: frlef65 (button) collected ($0.10)



PokerStars Hand #240823076363:  Hold'em No Limit ($0.01/$0.02 USD) - 2022/12/31 14:08:02 ET
Table 'Markab III' 6-max Seat #2 is the button
Seat 2: deck_pokemon ($2 in chips) 
Seat 3: flippinghand ($2.01 in chips) 
Seat 4: Lorpugo ($2.76 in chips) 
Seat 5: frlef65 ($2.39 in chips) 
flippinghand: posts small blind $0.01
Lorpugo: posts big blind $0.02
*** HOLE CARDS ***
Dealt to Lorpugo [7s 3d]
frlef65: folds 
deck_pokemon: folds 
flippinghand: folds 
Uncalled bet ($0.01) returned to Lorpugo
Lorpugo collected $0.02 from pot
Lorpugo: doesn't show hand 
*** SUMMARY ***
Total pot $0.02 | Rake $0 
Seat 2: deck_pokemon (button) folded before Flop (didn't bet)
Seat 3: flippinghand (small blind) folded before Flop
Seat 4: Lorpugo (big blind) collected ($0.02)
Seat 5: frlef65 folded before Flop (didn't bet)



PokerStars Hand #240823080651:  Hold'em No Limit ($0.01/$0.02 USD) - 2022/12/31 14:08:17 ET
Table 'Markab III' 6-max Seat #3 is the button
Seat 2: deck_pokemon ($2 in chips) 
Seat 3: flippinghand ($2 in chips) 
Seat 4: Lorpugo ($2.77 in chips) 
Seat 5: frlef65 ($2.39 in chips) 
Lorpugo: posts small blind $0.01
frlef65: posts big blind $0.02
*** HOLE CARDS ***
Dealt to Lorpugo [5c 3d]
deck_pokemon: raises $0.02 to $0.04
flippinghand: folds 
Lorpugo: folds 
frlef65: calls $0.02
*** FLOP *** [7s Ad Qc]
frlef65: bets $0.09
deck_pokemon: calls $0.09
*** TURN *** [7s Ad Qc] [2d]
frlef65: bets $0.13
deck_pokemon: folds 
Uncalled bet ($0.13) returned to frlef65
frlef65 collected $0.26 from pot
*** SUMMARY ***
Total pot $0.27 | Rake $0.01 
Board [7s Ad Qc 2d]
Seat 2: deck_pokemon folded on the Turn
Seat 3: flippinghand (button) folded before Flop (didn't bet)
Seat 4: Lorpugo (small blind) folded before Flop
Seat 5: frlef65 (big blind) collected ($0.26)



PokerStars Hand #240823088633:  Hold'em No Limit ($0.01/$0.02 USD) - 2022/12/31 14:08:46 ET
Table 'Markab III' 6-max Seat #4 is the button
Seat 2: deck_pokemon ($2 in chips) 
Seat 3: flippinghand ($2 in chips) 
Seat 4: Lorpugo ($2.76 in chips) 
Seat 5: frlef65 ($2.52 in chips) 
Seat 6: cartani1980 ($0.80 in chips) 
frlef65: posts small blind $0.01
cartani1980: posts big blind $0.02
*** HOLE CARDS ***
Dealt to Lorpugo [8d 9h]
deck_pokemon: folds 
flippinghand: folds 
Lorpugo: raises $0.04 to $0.06
frlef65: folds 
cartani1980: folds 
Uncalled bet ($0.04) returned to Lorpugo
Lorpugo collected $0.05 from pot
Lorpugo: doesn't show hand 
*** SUMMARY ***
Total pot $0.05 | Rake $0 
Seat 2: deck_pokemon folded before Flop (didn't bet)
Seat 3: flippinghand folded before Flop (didn't bet)
Seat 4: Lorpugo (button) collected ($0.05)
Seat 5: frlef65 (small blind) folded before Flop
Seat 6: cartani1980 (big blind) folded before Flop



PokerStars Hand #240823095505:  Hold'em No Limit ($0.01/$0.02 USD) - 2022/12/31 14:09:10 ET
Table 'Markab III' 6-max Seat #5 is the button
Seat 2: deck_pokemon ($2 in chips) 
Seat 3: flippinghand ($2 in chips) 
Seat 4: Lorpugo ($2.79 in chips) 
Seat 5: frlef65 ($2.51 in chips) 
Seat 6: cartani1980 ($0.78 in chips) 
cartani1980: posts small blind $0.01
deck_pokemon: posts big blind $0.02
*** HOLE CARDS ***
Dealt to Lorpugo [9d Ks]
flippinghand: folds 
Lorpugo: raises $0.04 to $0.06
frlef65: folds 
cartani1980: folds 
deck_pokemon: calls $0.04
*** FLOP *** [2s As 8d]
deck_pokemon: checks 
Lorpugo: bets $0.06
deck_pokemon: folds 
Uncalled bet ($0.06) returned to Lorpugo
Lorpugo collected $0.13 from pot
alexfm88 leaves the table
Lorpugo: doesn't show hand 
*** SUMMARY ***
Total pot $0.13 | Rake $0 
Board [2s As 8d]
Seat 2: deck_pokemon (big blind) folded on the Flop
Seat 3: flippinghand folded before Flop (didn't bet)
Seat 4: Lorpugo collected ($0.13)
Seat 5: frlef65 (button) folded before Flop (didn't bet)
Seat 6: cartani1980 (small blind) folded before Flop



PokerStars Hand #240823104593:  Hold'em No Limit ($0.01/$0.02 USD) - 2022/12/31 14:09:43 ET
Table 'Markab III' 6-max Seat #6 is the button
Seat 2: deck_pokemon ($2 in chips) 
Seat 3: flippinghand ($2 in chips) 
Seat 4: Lorpugo ($2.86 in chips) 
Seat 5: frlef65 ($2.51 in chips) 
Seat 6: cartani1980 ($0.77 in chips) 
deck_pokemon: posts small blind $0.01
flippinghand: posts big blind $0.02
*** HOLE CARDS ***
Dealt to Lorpugo [Tc Th]
Lorpugo: raises $0.04 to $0.06
frlef65: calls $0.06
cartani1980: folds 
deck_pokemon: folds 
flippinghand: calls $0.04
*** FLOP *** [Ts Qs 7d]
fraditomi1989 joins the table at seat #1 
flippinghand: checks 
Lorpugo: bets $0.09
frlef65: raises $0.18 to $0.27
flippinghand: folds 
Lorpugo: raises $2.53 to $2.80 and is all-in
frlef65: folds 
Uncalled bet ($2.53) returned to Lorpugo
Lorpugo collected $0.70 from pot
Lorpugo: doesn't show hand 
*** SUMMARY ***
Total pot $0.73 | Rake $0.03 
Board [Ts Qs 7d]
Seat 2: deck_pokemon (small blind) folded before Flop
Seat 3: flippinghand (big blind) folded on the Flop
Seat 4: Lorpugo collected ($0.70)
Seat 5: frlef65 folded on the Flop
Seat 6: cartani1980 (button) folded before Flop (didn't bet)



PokerStars Hand #240823119438:  Hold'em No Limit ($0.01/$0.02 USD) - 2022/12/31 14:10:36 ET
Table 'Markab III' 6-max Seat #2 is the button
Seat 2: deck_pokemon ($2 in chips) 
Seat 3: flippinghand ($2 in chips) 
Seat 4: Lorpugo ($3.23 in chips) 
Seat 5: frlef65 ($2.18 in chips) 
Seat 6: cartani1980 ($0.77 in chips) 
flippinghand: posts small blind $0.01
Lorpugo: posts big blind $0.02
*** HOLE CARDS ***
Dealt to Lorpugo [As 3h]
frlef65: folds 
cartani1980: folds 
deck_pokemon: folds 
flippinghand: folds 
Uncalled bet ($0.01) returned to Lorpugo
Lorpugo collected $0.02 from pot
Lorpugo: doesn't show hand 
*** SUMMARY ***
Total pot $0.02 | Rake $0 
Seat 2: deck_pokemon (button) folded before Flop (didn't bet)
Seat 3: flippinghand (small blind) folded before Flop
Seat 4: Lorpugo (big blind) collected ($0.02)
Seat 5: frlef65 folded before Flop (didn't bet)
Seat 6: cartani1980 folded before Flop (didn't bet)



PokerStars Hand #240823123112:  Hold'em No Limit ($0.01/$0.02 USD) - 2022/12/31 14:10:49 ET
Table 'Markab III' 6-max Seat #3 is the button
Seat 1: fraditomi1989 ($1.60 in chips) 
Seat 2: deck_pokemon ($2 in chips) 
Seat 3: flippinghand ($1.99 in chips) 
Seat 4: Lorpugo ($3.24 in chips) 
Seat 5: frlef65 ($2.18 in chips) 
Seat 6: cartani1980 ($0.77 in chips) 
Lorpugo: posts small blind $0.01
frlef65: posts big blind $0.02
fraditomi1989: posts big blind $0.02
*** HOLE CARDS ***
Dealt to Lorpugo [3d 6c]
cartani1980: folds 
fraditomi1989: checks 
deck_pokemon: folds 
flippinghand: folds 
Lorpugo: folds 
frlef65: checks 
*** FLOP *** [Ad 5s Qd]
frlef65: bets $0.03
fraditomi1989: folds 
Uncalled bet ($0.03) returned to frlef65
frlef65 collected $0.05 from pot
*** SUMMARY ***
Total pot $0.05 | Rake $0 
Board [Ad 5s Qd]
Seat 1: fraditomi1989 folded on the Flop (didn't bet)
Seat 2: deck_pokemon folded before Flop (didn't bet)
Seat 3: flippinghand (button) folded before Flop (didn't bet)
Seat 4: Lorpugo (small blind) folded before Flop
Seat 5: frlef65 (big blind) collected ($0.05)
Seat 6: cartani1980 folded before Flop (didn't bet)



PokerStars Hand #240823133092:  Hold'em No Limit ($0.01/$0.02 USD) - 2022/12/31 14:11:25 ET
Table 'Markab III' 6-max Seat #4 is the button
Seat 1: fraditomi1989 ($1.58 in chips) 
Seat 2: deck_pokemon ($2 in chips) 
Seat 3: flippinghand ($1.99 in chips) 
Seat 4: Lorpugo ($3.23 in chips) 
Seat 5: frlef65 ($2.21 in chips) 
Seat 6: cartani1980 ($0.77 in chips) 
frlef65: posts small blind $0.01
cartani1980: posts big blind $0.02
*** HOLE CARDS ***
Dealt to Lorpugo [2s 9c]
fraditomi1989: raises $0.06 to $0.08
deck_pokemon: calls $0.08
flippinghand: folds 
flippinghand leaves the table
Lorpugo: folds 
frlef65: folds 
cartani1980: folds 
*** FLOP *** [2d Kc 8d]
cartani1980 leaves the table
fraditomi1989: bets $0.06
deck_pokemon: calls $0.06
*** TURN *** [2d Kc 8d] [8s]
fraditomi1989: bets $0.04
deck_pokemon: calls $0.04
*** RIVER *** [2d Kc 8d 8s] [Qs]
fraditomi1989: checks 
deck_pokemon: checks 
*** SHOW DOWN ***
fraditomi1989: shows [6d 9s] (a pair of Eights)
deck_pokemon: shows [7s 7h] (two pair, Eights and Sevens)
deck_pokemon collected $0.38 from pot
hotel64 joins the table at seat #3 
*** SUMMARY ***
Total pot $0.39 | Rake $0.01 
Board [2d Kc 8d 8s Qs]
Seat 1: fraditomi1989 showed [6d 9s] and lost with a pair of Eights
Seat 2: deck_pokemon showed [7s 7h] and won ($0.38) with two pair, Eights and Sevens
Seat 3: flippinghand folded before Flop (didn't bet)
Seat 4: Lorpugo (button) folded before Flop (didn't bet)
Seat 5: frlef65 (small blind) folded before Flop
Seat 6: cartani1980 (big blind) folded before Flop



PokerStars Hand #240823146344:  Hold'em No Limit ($0.01/$0.02 USD) - 2022/12/31 14:12:13 ET
Table 'Markab III' 6-max Seat #5 is the button
Seat 1: fraditomi1989 ($1.40 in chips) 
Seat 2: deck_pokemon ($2.20 in chips) 
Seat 4: Lorpugo ($3.23 in chips) 
Seat 5: frlef65 ($2.20 in chips) 
fraditomi1989: posts small blind $0.01
deck_pokemon: posts big blind $0.02
*** HOLE CARDS ***
Dealt to Lorpugo [5c 3d]
Lorpugo: folds 
frlef65: folds 
fraditomi1989: calls $0.01
hotel64 leaves the table
deck_pokemon: checks 
*** FLOP *** [7s Ac Ks]
fraditomi1989: bets $0.10
deck_pokemon: folds 
Uncalled bet ($0.10) returned to fraditomi1989
fraditomi1989 collected $0.04 from pot
*** SUMMARY ***
Total pot $0.04 | Rake $0 
Board [7s Ac Ks]
Seat 1: fraditomi1989 (small blind) collected ($0.04)
Seat 2: deck_pokemon (big blind) folded on the Flop
Seat 4: Lorpugo folded before Flop (didn't bet)
Seat 5: frlef65 (button) folded before Flop (didn't bet)



PokerStars Hand #240823154475:  Hold'em No Limit ($0.01/$0.02 USD) - 2022/12/31 14:12:42 ET
Table 'Markab III' 6-max Seat #1 is the button
Seat 1: fraditomi1989 ($1.42 in chips) 
Seat 2: deck_pokemon ($2.18 in chips) 
Seat 4: Lorpugo ($3.23 in chips) 
Seat 5: frlef65 ($2.20 in chips) 
deck_pokemon: posts small blind $0.01
Lorpugo: posts big blind $0.02
*** HOLE CARDS ***
Dealt to Lorpugo [2d Qh]
frlef65: folds 
fraditomi1989: calls $0.02
Ramirres joins the table at seat #6 
deck_pokemon: folds 
Lorpugo: checks 
*** FLOP *** [5d 9c 6c]
Lorpugo: checks 
fraditomi1989: checks 
*** TURN *** [5d 9c 6c] [8c]
RBS2589 joins the table at seat #3 
Lorpugo: checks 
fraditomi1989: checks 
*** RIVER *** [5d 9c 6c 8c] [As]
Lorpugo: checks 
fraditomi1989: bets $0.06
Lorpugo: folds 
Uncalled bet ($0.06) returned to fraditomi1989
fraditomi1989 collected $0.05 from pot
*** SUMMARY ***
Total pot $0.05 | Rake $0 
Board [5d 9c 6c 8c As]
Seat 1: fraditomi1989 (button) collected ($0.05)
Seat 2: deck_pokemon (small blind) folded before Flop
Seat 4: Lorpugo (big blind) folded on the River
Seat 5: frlef65 folded before Flop (didn't bet)



PokerStars Hand #240823164777:  Hold'em No Limit ($0.01/$0.02 USD) - 2022/12/31 14:13:19 ET
Table 'Markab III' 6-max Seat #2 is the button
Seat 1: fraditomi1989 ($1.45 in chips) 
Seat 2: deck_pokemon ($2.17 in chips) 
Seat 4: Lorpugo ($3.21 in chips) 
Seat 5: frlef65 ($2.20 in chips) 
Lorpugo: posts small blind $0.01
frlef65: posts big blind $0.02
*** HOLE CARDS ***
Dealt to Lorpugo [Kh 9s]
fraditomi1989: raises $1.43 to $1.45 and is all-in
deck_pokemon: folds 
Lorpugo: folds 
frlef65: folds 
Uncalled bet ($1.43) returned to fraditomi1989
fraditomi1989 collected $0.05 from pot
*** SUMMARY ***
Total pot $0.05 | Rake $0 
Seat 1: fraditomi1989 collected ($0.05)
Seat 2: deck_pokemon (button) folded before Flop (didn't bet)
Seat 4: Lorpugo (small blind) folded before Flop
Seat 5: frlef65 (big blind) folded before Flop



PokerStars Hand #240823169937:  Hold'em No Limit ($0.01/$0.02 USD) - 2022/12/31 14:13:38 ET
Table 'Markab III' 6-max Seat #4 is the button
Seat 1: fraditomi1989 ($1.48 in chips) 
Seat 2: deck_pokemon ($2.17 in chips) 
Seat 4: Lorpugo ($3.20 in chips) 
Seat 5: frlef65 ($2.18 in chips) 
Seat 6: Ramirres ($2 in chips) 
frlef65: posts small blind $0.01
Ramirres: posts big blind $0.02
*** HOLE CARDS ***
Dealt to Lorpugo [Td 2c]
fraditomi1989: raises $1.46 to $1.48 and is all-in
deck_pokemon: folds 
Lorpugo: folds 
frlef65: folds 
Ramirres: folds 
Uncalled bet ($1.46) returned to fraditomi1989
fraditomi1989 collected $0.05 from pot
*** SUMMARY ***
Total pot $0.05 | Rake $0 
Seat 1: fraditomi1989 collected ($0.05)
Seat 2: deck_pokemon folded before Flop (didn't bet)
Seat 4: Lorpugo (button) folded before Flop (didn't bet)
Seat 5: frlef65 (small blind) folded before Flop
Seat 6: Ramirres (big blind) folded before Flop



PokerStars Hand #240823173431:  Hold'em No Limit ($0.01/$0.02 USD) - 2022/12/31 14:13:51 ET
Table 'Markab III' 6-max Seat #5 is the button
Seat 1: fraditomi1989 ($1.51 in chips) 
Seat 2: deck_pokemon ($2.17 in chips) 
Seat 4: Lorpugo ($3.20 in chips) 
Seat 5: frlef65 ($2.17 in chips) 
Seat 6: Ramirres ($2 in chips) 
Ramirres: posts small blind $0.01
fraditomi1989: posts big blind $0.02
*** HOLE CARDS ***
Dealt to Lorpugo [5d Qh]
deck_pokemon: folds 
Lorpugo: folds 
frlef65: folds 
Ramirres: raises $0.03 to $0.05
fraditomi1989: raises $0.19 to $0.24
Ramirres: folds 
Uncalled bet ($0.19) returned to fraditomi1989
fraditomi1989 collected $0.10 from pot
*** SUMMARY ***
Total pot $0.10 | Rake $0 
Seat 1: fraditomi1989 (big blind) collected ($0.10)
Seat 2: deck_pokemon folded before Flop (didn't bet)
Seat 4: Lorpugo folded before Flop (didn't bet)
Seat 5: frlef65 (button) folded before Flop (didn't bet)
Seat 6: Ramirres (small blind) folded before Flop



PokerStars Hand #240823180637:  Hold'em No Limit ($0.01/$0.02 USD) - 2022/12/31 14:14:17 ET
Table 'Markab III' 6-max Seat #6 is the button
Seat 1: fraditomi1989 ($1.56 in chips) 
Seat 2: deck_pokemon ($2.17 in chips) 
Seat 4: Lorpugo ($3.20 in chips) 
Seat 5: frlef65 ($2.17 in chips) 
Seat 6: Ramirres ($2 in chips) 
fraditomi1989: posts small blind $0.01
deck_pokemon: posts big blind $0.02
*** HOLE CARDS ***
Dealt to Lorpugo [Jd 9s]
Lorpugo: folds 
frlef65: calls $0.02
Ramirres: raises $0.04 to $0.06
fraditomi1989: calls $0.05
deck_pokemon: folds 
frlef65: calls $0.04
*** FLOP *** [Js 7s Td]
fraditomi1989: checks 
frlef65: bets $0.19
Ramirres: calls $0.19
fraditomi1989: folds 
*** TURN *** [Js 7s Td] [As]
frlef65: bets $0.56
Ramirres: calls $0.56
*** RIVER *** [Js 7s Td As] [9c]
frlef65: bets $1.36 and is all-in
Ramirres: calls $1.19 and is all-in
Uncalled bet ($0.17) returned to frlef65
*** SHOW DOWN ***
frlef65: shows [2h Jh] (a pair of Jacks)
Ramirres: shows [Qd Kc] (a straight, Ten to Ace)
Ramirres collected $3.94 from pot
*** SUMMARY ***
Total pot $4.08 | Rake $0.14 
Board [Js 7s Td As 9c]
Seat 1: fraditomi1989 (small blind) folded on the Flop
Seat 2: deck_pokemon (big blind) folded before Flop
Seat 4: Lorpugo folded before Flop (didn't bet)
Seat 5: frlef65 showed [2h Jh] and lost with a pair of Jacks
Seat 6: Ramirres (button) showed [Qd Kc] and won ($3.94) with a straight, Ten to Ace



