PokerStars Hand #240733374650:  Hold'em No Limit ($0.01/$0.02 USD) - 2022/12/27 15:07:31 ET
Table 'Ilsebill' 6-max Seat #2 is the button
Seat 2: 8AndreM9 ($2.24 in chips) 
Seat 4: 19dave72 ($2.36 in chips) 
Seat 5: Lorpugo ($1.60 in chips) 
Seat 6: astca ($1.33 in chips) 
19dave72: posts small blind $0.01
Lorpugo: posts big blind $0.02
*** HOLE CARDS ***
Dealt to Lorpugo [Kc 7h]
astca: raises $0.05 to $0.07
8AndreM9: folds 
19dave72: folds 
Lorpugo: folds 
Uncalled bet ($0.05) returned to astca
astca collected $0.05 from pot
*** SUMMARY ***
Total pot $0.05 | Rake $0 
Seat 2: 8AndreM9 (button) folded before Flop (didn't bet)
Seat 4: 19dave72 (small blind) folded before Flop
Seat 5: Lorpugo (big blind) folded before Flop
Seat 6: astca collected ($0.05)



PokerStars Hand #240733379191:  Hold'em No Limit ($0.01/$0.02 USD) - 2022/12/27 15:07:41 ET
Table 'Ilsebill' 6-max Seat #4 is the button
Seat 2: 8AndreM9 ($2.24 in chips) 
Seat 4: 19dave72 ($2.35 in chips) 
Seat 5: Lorpugo ($1.58 in chips) 
Seat 6: astca ($1.36 in chips) 
Lorpugo: posts small blind $0.01
astca: posts big blind $0.02
*** HOLE CARDS ***
Dealt to Lorpugo [9s 5s]
8AndreM9: folds 
19dave72: raises $0.04 to $0.06
Lorpugo: folds 
astca: folds 
Uncalled bet ($0.04) returned to 19dave72
19dave72 collected $0.05 from pot
19dave72: doesn't show hand 
*** SUMMARY ***
Total pot $0.05 | Rake $0 
Seat 2: 8AndreM9 folded before Flop (didn't bet)
Seat 4: 19dave72 (button) collected ($0.05)
Seat 5: Lorpugo (small blind) folded before Flop
Seat 6: astca (big blind) folded before Flop



PokerStars Hand #240733384457:  Hold'em No Limit ($0.01/$0.02 USD) - 2022/12/27 15:07:51 ET
Table 'Ilsebill' 6-max Seat #5 is the button
Seat 1: EderAmarilla ($2 in chips) 
Seat 2: 8AndreM9 ($2.24 in chips) 
Seat 4: 19dave72 ($2.38 in chips) 
Seat 5: Lorpugo ($1.57 in chips) 
Seat 6: astca ($1.34 in chips) 
astca: posts small blind $0.01
EderAmarilla: posts big blind $0.02
*** HOLE CARDS ***
Dealt to Lorpugo [Qc 5d]
8AndreM9: calls $0.02
19dave72: folds 
hleroy joins the table at seat #3 
Lorpugo: folds 
astca: folds 
EderAmarilla: checks 
*** FLOP *** [Th Ad Ts]
EderAmarilla: checks 
8AndreM9: bets $0.02
EderAmarilla: calls $0.02
*** TURN *** [Th Ad Ts] [9d]
hleroy leaves the table
EderAmarilla: checks 
8AndreM9: bets $0.04
EderAmarilla: folds 
Uncalled bet ($0.04) returned to 8AndreM9
8AndreM9 collected $0.09 from pot
*** SUMMARY ***
Total pot $0.09 | Rake $0 
Board [Th Ad Ts 9d]
Seat 1: EderAmarilla (big blind) folded on the Turn
Seat 2: 8AndreM9 collected ($0.09)
Seat 4: 19dave72 folded before Flop (didn't bet)
Seat 5: Lorpugo (button) folded before Flop (didn't bet)
Seat 6: astca (small blind) folded before Flop



PokerStars Hand #240733399217:  Hold'em No Limit ($0.01/$0.02 USD) - 2022/12/27 15:08:22 ET
Table 'Ilsebill' 6-max Seat #6 is the button
Seat 1: EderAmarilla ($2 in chips) 
Seat 2: 8AndreM9 ($2.29 in chips) 
Seat 4: 19dave72 ($2.38 in chips) 
Seat 5: Lorpugo ($1.57 in chips) 
Seat 6: astca ($1.33 in chips) 
EderAmarilla: posts small blind $0.01
8AndreM9: posts big blind $0.02
*** HOLE CARDS ***
Dealt to Lorpugo [4c 6h]
19dave72: folds 
Lorpugo: folds 
astca: folds 
EderAmarilla: raises $0.04 to $0.06
8AndreM9: calls $0.04
*** FLOP *** [Ac Kd 9d]
EderAmarilla: bets $0.06
8AndreM9: folds 
Uncalled bet ($0.06) returned to EderAmarilla
EderAmarilla collected $0.12 from pot
EderAmarilla: doesn't show hand 
*** SUMMARY ***
Total pot $0.12 | Rake $0 
Board [Ac Kd 9d]
Seat 1: EderAmarilla (small blind) collected ($0.12)
Seat 2: 8AndreM9 (big blind) folded on the Flop
Seat 4: 19dave72 folded before Flop (didn't bet)
Seat 5: Lorpugo folded before Flop (didn't bet)
Seat 6: astca (button) folded before Flop (didn't bet)



PokerStars Hand #240733412641:  Hold'em No Limit ($0.01/$0.02 USD) - 2022/12/27 15:08:49 ET
Table 'Ilsebill' 6-max Seat #1 is the button
Seat 1: EderAmarilla ($2.06 in chips) 
Seat 2: 8AndreM9 ($2.23 in chips) 
Seat 4: 19dave72 ($2.38 in chips) 
Seat 5: Lorpugo ($1.57 in chips) 
Seat 6: astca ($1.33 in chips) 
kadoboy21 joins the table at seat #3 
8AndreM9: posts small blind $0.01
19dave72: posts big blind $0.02
*** HOLE CARDS ***
Dealt to Lorpugo [6c Kc]
Lorpugo: folds 
astca: raises $0.05 to $0.07
EderAmarilla: folds 
8AndreM9: folds 
19dave72: folds 
Uncalled bet ($0.05) returned to astca
astca collected $0.05 from pot
*** SUMMARY ***
Total pot $0.05 | Rake $0 
Seat 1: EderAmarilla (button) folded before Flop (didn't bet)
Seat 2: 8AndreM9 (small blind) folded before Flop
Seat 4: 19dave72 (big blind) folded before Flop
Seat 5: Lorpugo folded before Flop (didn't bet)
Seat 6: astca collected ($0.05)



PokerStars Hand #240733419833:  Hold'em No Limit ($0.01/$0.02 USD) - 2022/12/27 15:09:04 ET
Table 'Ilsebill' 6-max Seat #2 is the button
Seat 1: EderAmarilla ($2.06 in chips) 
Seat 2: 8AndreM9 ($2.22 in chips) 
Seat 4: 19dave72 ($2.36 in chips) 
Seat 5: Lorpugo ($1.57 in chips) 
Seat 6: astca ($1.36 in chips) 
19dave72: posts small blind $0.01
Lorpugo: posts big blind $0.02
*** HOLE CARDS ***
Dealt to Lorpugo [Ah 5d]
astca: folds 
EderAmarilla: folds 
8AndreM9: calls $0.02
19dave72: folds 
Lorpugo: checks 
*** FLOP *** [8c 2s Qd]
Lorpugo: checks 
8AndreM9: checks 
*** TURN *** [8c 2s Qd] [7c]
Lorpugo: checks 
8AndreM9: checks 
*** RIVER *** [8c 2s Qd 7c] [9s]
Lorpugo: checks 
8AndreM9: checks 
*** SHOW DOWN ***
Lorpugo: shows [Ah 5d] (high card Ace)
8AndreM9: mucks hand 
Lorpugo collected $0.05 from pot
*** SUMMARY ***
Total pot $0.05 | Rake $0 
Board [8c 2s Qd 7c 9s]
Seat 1: EderAmarilla folded before Flop (didn't bet)
Seat 2: 8AndreM9 (button) mucked [Kh Tc]
Seat 4: 19dave72 (small blind) folded before Flop
Seat 5: Lorpugo (big blind) showed [Ah 5d] and won ($0.05) with high card Ace
Seat 6: astca folded before Flop (didn't bet)



PokerStars Hand #240733436893:  Hold'em No Limit ($0.01/$0.02 USD) - 2022/12/27 15:09:39 ET
Table 'Ilsebill' 6-max Seat #4 is the button
Seat 1: EderAmarilla ($2.06 in chips) 
Seat 2: 8AndreM9 ($2.20 in chips) 
Seat 3: kadoboy21 ($2 in chips) 
Seat 4: 19dave72 ($2.35 in chips) 
Seat 5: Lorpugo ($1.60 in chips) 
Seat 6: astca ($1.36 in chips) 
Lorpugo: posts small blind $0.01
astca: posts big blind $0.02
kadoboy21: posts big blind $0.02
*** HOLE CARDS ***
Dealt to Lorpugo [Js 8h]
EderAmarilla: raises $0.04 to $0.06
8AndreM9: calls $0.06
kadoboy21 has timed out
kadoboy21: folds 
19dave72: folds 
Lorpugo: folds 
astca: calls $0.04
*** FLOP *** [7c Ts 4s]
astca: checks 
EderAmarilla: checks 
8AndreM9: checks 
*** TURN *** [7c Ts 4s] [9s]
astca: checks 
EderAmarilla: bets $0.10
8AndreM9: calls $0.10
astca: folds 
*** RIVER *** [7c Ts 4s 9s] [8d]
EderAmarilla: bets $0.30
8AndreM9: calls $0.30
*** SHOW DOWN ***
EderAmarilla: shows [Ks Qd] (high card King)
8AndreM9: shows [Jh 8s] (a straight, Seven to Jack)
8AndreM9 collected $0.97 from pot
*** SUMMARY ***
Total pot $1.01 | Rake $0.04 
Board [7c Ts 4s 9s 8d]
Seat 1: EderAmarilla showed [Ks Qd] and lost with high card King
Seat 2: 8AndreM9 showed [Jh 8s] and won ($0.97) with a straight, Seven to Jack
Seat 3: kadoboy21 folded before Flop (didn't bet)
Seat 4: 19dave72 (button) folded before Flop (didn't bet)
Seat 5: Lorpugo (small blind) folded before Flop
Seat 6: astca (big blind) folded on the Turn



PokerStars Hand #240733473279:  Hold'em No Limit ($0.01/$0.02 USD) - 2022/12/27 15:10:55 ET
Table 'Ilsebill' 6-max Seat #5 is the button
Seat 1: EderAmarilla ($2 in chips) 
Seat 2: 8AndreM9 ($2.71 in chips) 
Seat 4: 19dave72 ($2.35 in chips) 
Seat 5: Lorpugo ($1.59 in chips) 
Seat 6: astca ($1.30 in chips) 
astca: posts small blind $0.01
EderAmarilla: posts big blind $0.02
*** HOLE CARDS ***
Dealt to Lorpugo [7c Ac]
8AndreM9: folds 
19dave72: folds 
Lorpugo: raises $0.04 to $0.06
astca: calls $0.05
EderAmarilla: calls $0.04
*** FLOP *** [Tc Ts Qs]
astca: checks 
EderAmarilla: checks 
Lorpugo: bets $0.09
astca: folds 
EderAmarilla: calls $0.09
*** TURN *** [Tc Ts Qs] [2d]
EderAmarilla: checks 
Lorpugo: checks 
*** RIVER *** [Tc Ts Qs 2d] [6c]
EderAmarilla: checks 
Lorpugo: checks 
*** SHOW DOWN ***
EderAmarilla: shows [9h Jh] (a pair of Tens)
Lorpugo: shows [7c Ac] (a pair of Tens - Ace kicker)
Lorpugo collected $0.35 from pot
*** SUMMARY ***
Total pot $0.36 | Rake $0.01 
Board [Tc Ts Qs 2d 6c]
Seat 1: EderAmarilla (big blind) showed [9h Jh] and lost with a pair of Tens
Seat 2: 8AndreM9 folded before Flop (didn't bet)
Seat 4: 19dave72 folded before Flop (didn't bet)
Seat 5: Lorpugo (button) showed [7c Ac] and won ($0.35) with a pair of Tens
Seat 6: astca (small blind) folded on the Flop



PokerStars Hand #240733505478:  Hold'em No Limit ($0.01/$0.02 USD) - 2022/12/27 15:12:02 ET
Table 'Ilsebill' 6-max Seat #6 is the button
Seat 1: EderAmarilla ($2 in chips) 
Seat 2: 8AndreM9 ($2.71 in chips) 
Seat 4: 19dave72 ($2.35 in chips) 
Seat 5: Lorpugo ($1.79 in chips) 
Seat 6: astca ($1.24 in chips) 
EderAmarilla: posts small blind $0.01
8AndreM9: posts big blind $0.02
*** HOLE CARDS ***
Dealt to Lorpugo [Kh Qs]
19dave72: folds 
Lorpugo: raises $0.04 to $0.06
astca: folds 
EderAmarilla: raises $0.18 to $0.24
8AndreM9: folds 
Lorpugo: calls $0.18
*** FLOP *** [5s 8h Ac]
EderAmarilla: bets $0.20
Lorpugo: folds 
Uncalled bet ($0.20) returned to EderAmarilla
EderAmarilla collected $0.48 from pot
EderAmarilla: doesn't show hand 
*** SUMMARY ***
Total pot $0.50 | Rake $0.02 
Board [5s 8h Ac]
Seat 1: EderAmarilla (small blind) collected ($0.48)
Seat 2: 8AndreM9 (big blind) folded before Flop
Seat 4: 19dave72 folded before Flop (didn't bet)
Seat 5: Lorpugo folded on the Flop
Seat 6: astca (button) folded before Flop (didn't bet)



PokerStars Hand #240733530152:  Hold'em No Limit ($0.01/$0.02 USD) - 2022/12/27 15:12:52 ET
Table 'Ilsebill' 6-max Seat #1 is the button
Seat 1: EderAmarilla ($2.24 in chips) 
Seat 2: 8AndreM9 ($2.69 in chips) 
Seat 4: 19dave72 ($2.35 in chips) 
Seat 5: Lorpugo ($1.55 in chips) 
Seat 6: astca ($1.24 in chips) 
8AndreM9: posts small blind $0.01
19dave72: posts big blind $0.02
*** HOLE CARDS ***
Dealt to Lorpugo [6d 6s]
Lorpugo: raises $0.04 to $0.06
astca: folds 
EderAmarilla: folds 
8AndreM9: calls $0.05
19dave72: folds 
*** FLOP *** [As 8c 8s]
8AndreM9: checks 
Lorpugo: bets $0.05
8AndreM9: calls $0.05
*** TURN *** [As 8c 8s] [2s]
8AndreM9: checks 
Lorpugo: checks 
*** RIVER *** [As 8c 8s 2s] [5h]
8AndreM9: bets $0.12
Lorpugo: folds 
Uncalled bet ($0.12) returned to 8AndreM9
8AndreM9 collected $0.23 from pot
*** SUMMARY ***
Total pot $0.24 | Rake $0.01 
Board [As 8c 8s 2s 5h]
Seat 1: EderAmarilla (button) folded before Flop (didn't bet)
Seat 2: 8AndreM9 (small blind) collected ($0.23)
Seat 4: 19dave72 (big blind) folded before Flop
Seat 5: Lorpugo folded on the River
Seat 6: astca folded before Flop (didn't bet)



PokerStars Hand #240733554352:  Hold'em No Limit ($0.01/$0.02 USD) - 2022/12/27 15:13:42 ET
Table 'Ilsebill' 6-max Seat #2 is the button
Seat 1: EderAmarilla ($2.24 in chips) 
Seat 2: 8AndreM9 ($2.81 in chips) 
Seat 4: 19dave72 ($2.33 in chips) 
Seat 5: Lorpugo ($1.44 in chips) 
Seat 6: astca ($1.24 in chips) 
19dave72: posts small blind $0.01
Lorpugo: posts big blind $0.02
*** HOLE CARDS ***
Dealt to Lorpugo [Jh 5c]
astca: raises $0.05 to $0.07
EderAmarilla: calls $0.07
8AndreM9: calls $0.07
19dave72: folds 
Lorpugo: folds 
*** FLOP *** [Ad 5s 6d]
astca: bets $0.12
EderAmarilla: folds 
8AndreM9: folds 
Uncalled bet ($0.12) returned to astca
astca collected $0.23 from pot
*** SUMMARY ***
Total pot $0.24 | Rake $0.01 
Board [Ad 5s 6d]
Seat 1: EderAmarilla folded on the Flop
Seat 2: 8AndreM9 (button) folded on the Flop
Seat 4: 19dave72 (small blind) folded before Flop
Seat 5: Lorpugo (big blind) folded before Flop
Seat 6: astca collected ($0.23)



PokerStars Hand #240733565959:  Hold'em No Limit ($0.01/$0.02 USD) - 2022/12/27 15:14:06 ET
Table 'Ilsebill' 6-max Seat #4 is the button
Seat 1: EderAmarilla ($2.17 in chips) 
Seat 2: 8AndreM9 ($2.74 in chips) 
Seat 4: 19dave72 ($2.32 in chips) 
Seat 5: Lorpugo ($1.42 in chips) 
Seat 6: astca ($1.40 in chips) 
Lorpugo: posts small blind $0.01
astca: posts big blind $0.02
*** HOLE CARDS ***
Dealt to Lorpugo [Kd 3h]
EderAmarilla: raises $0.04 to $0.06
8AndreM9: calls $0.06
19dave72: folds 
Lorpugo: folds 
astca: calls $0.04
*** FLOP *** [Ts Jc Ah]
astca: checks 
EderAmarilla: bets $0.10
8AndreM9: folds 
astca: calls $0.10
*** TURN *** [Ts Jc Ah] [Qs]
astca: checks 
EderAmarilla: checks 
*** RIVER *** [Ts Jc Ah Qs] [Ad]
astca: checks 
EderAmarilla: bets $0.38
astca: folds 
Uncalled bet ($0.38) returned to EderAmarilla
EderAmarilla collected $0.38 from pot
EderAmarilla: doesn't show hand 
*** SUMMARY ***
Total pot $0.39 | Rake $0.01 
Board [Ts Jc Ah Qs Ad]
Seat 1: EderAmarilla collected ($0.38)
Seat 2: 8AndreM9 folded on the Flop
Seat 4: 19dave72 (button) folded before Flop (didn't bet)
Seat 5: Lorpugo (small blind) folded before Flop
Seat 6: astca (big blind) folded on the River



PokerStars Hand #240733583917:  Hold'em No Limit ($0.01/$0.02 USD) - 2022/12/27 15:14:44 ET
Table 'Ilsebill' 6-max Seat #5 is the button
Seat 1: EderAmarilla ($2.39 in chips) 
Seat 2: 8AndreM9 ($2.68 in chips) 
Seat 4: 19dave72 ($2.32 in chips) 
Seat 5: Lorpugo ($1.41 in chips) 
Seat 6: astca ($1.24 in chips) 
astca: posts small blind $0.01
EderAmarilla: posts big blind $0.02
*** HOLE CARDS ***
Dealt to Lorpugo [7d Jh]
8AndreM9: raises $0.02 to $0.04
19dave72: folds 
Lorpugo: folds 
astca: folds 
EderAmarilla: folds 
Uncalled bet ($0.02) returned to 8AndreM9
8AndreM9 collected $0.05 from pot
*** SUMMARY ***
Total pot $0.05 | Rake $0 
Seat 1: EderAmarilla (big blind) folded before Flop
Seat 2: 8AndreM9 collected ($0.05)
Seat 4: 19dave72 folded before Flop (didn't bet)
Seat 5: Lorpugo (button) folded before Flop (didn't bet)
Seat 6: astca (small blind) folded before Flop



PokerStars Hand #240733590310:  Hold'em No Limit ($0.01/$0.02 USD) - 2022/12/27 15:14:58 ET
Table 'Ilsebill' 6-max Seat #6 is the button
Seat 1: EderAmarilla ($2.37 in chips) 
Seat 2: 8AndreM9 ($2.71 in chips) 
Seat 3: kadoboy21 ($1.98 in chips) 
Seat 4: 19dave72 ($2.32 in chips) 
Seat 5: Lorpugo ($1.41 in chips) 
Seat 6: astca ($1.23 in chips) 
EderAmarilla: posts small blind $0.01
8AndreM9: posts big blind $0.02
kadoboy21: posts small & big blinds $0.03
*** HOLE CARDS ***
Dealt to Lorpugo [5h Kc]
kadoboy21: checks 
19dave72: folds 
Lorpugo: folds 
astca: folds 
EderAmarilla: folds 
8AndreM9: checks 
*** FLOP *** [Tc Th 3c]
8AndreM9: checks 
kadoboy21: bets $0.02
8AndreM9: calls $0.02
*** TURN *** [Tc Th 3c] [6h]
8AndreM9: checks 
kadoboy21: bets $0.02
8AndreM9: calls $0.02
*** RIVER *** [Tc Th 3c 6h] [7s]
8AndreM9: checks 
kadoboy21: bets $0.02
8AndreM9: calls $0.02
*** SHOW DOWN ***
kadoboy21: shows [8c 3s] (two pair, Tens and Threes)
8AndreM9: shows [Qc 7c] (two pair, Tens and Sevens)
8AndreM9 collected $0.17 from pot
*** SUMMARY ***
Total pot $0.18 | Rake $0.01 
Board [Tc Th 3c 6h 7s]
Seat 1: EderAmarilla (small blind) folded before Flop
Seat 2: 8AndreM9 (big blind) showed [Qc 7c] and won ($0.17) with two pair, Tens and Sevens
Seat 3: kadoboy21 showed [8c 3s] and lost with two pair, Tens and Threes
Seat 4: 19dave72 folded before Flop (didn't bet)
Seat 5: Lorpugo folded before Flop (didn't bet)
Seat 6: astca (button) folded before Flop (didn't bet)



PokerStars Hand #240733612361:  Hold'em No Limit ($0.01/$0.02 USD) - 2022/12/27 15:15:44 ET
Table 'Ilsebill' 6-max Seat #1 is the button
Seat 1: EderAmarilla ($2.36 in chips) 
Seat 2: 8AndreM9 ($2.80 in chips) 
Seat 3: kadoboy21 ($1.89 in chips) 
Seat 4: 19dave72 ($2.32 in chips) 
Seat 5: Lorpugo ($1.41 in chips) 
Seat 6: astca ($1.23 in chips) 
8AndreM9: posts small blind $0.01
kadoboy21: posts big blind $0.02
*** HOLE CARDS ***
Dealt to Lorpugo [7h Jc]
19dave72: folds 
Lorpugo: folds 
astca: folds 
EderAmarilla: raises $0.04 to $0.06
8AndreM9: calls $0.05
kadoboy21: folds 
*** FLOP *** [5c 3d 5h]
8AndreM9: checks 
EderAmarilla: bets $0.06
8AndreM9: folds 
Uncalled bet ($0.06) returned to EderAmarilla
EderAmarilla collected $0.14 from pot
EderAmarilla: doesn't show hand 
*** SUMMARY ***
Total pot $0.14 | Rake $0 
Board [5c 3d 5h]
Seat 1: EderAmarilla (button) collected ($0.14)
Seat 2: 8AndreM9 (small blind) folded on the Flop
Seat 3: kadoboy21 (big blind) folded before Flop
Seat 4: 19dave72 folded before Flop (didn't bet)
Seat 5: Lorpugo folded before Flop (didn't bet)
Seat 6: astca folded before Flop (didn't bet)



PokerStars Hand #240733629334:  Hold'em No Limit ($0.01/$0.02 USD) - 2022/12/27 15:16:19 ET
Table 'Ilsebill' 6-max Seat #2 is the button
Seat 1: EderAmarilla ($2.44 in chips) 
Seat 2: 8AndreM9 ($2.74 in chips) 
Seat 3: kadoboy21 ($1.87 in chips) 
Seat 4: 19dave72 ($2.32 in chips) 
Seat 5: Lorpugo ($1.41 in chips) 
Seat 6: astca ($1.23 in chips) 
kadoboy21: posts small blind $0.01
19dave72: posts big blind $0.02
*** HOLE CARDS ***
Dealt to Lorpugo [7c 5c]
Lorpugo: folds 
astca: raises $0.05 to $0.07
EderAmarilla: folds 
8AndreM9: folds 
kadoboy21: calls $0.06
19dave72: folds 
*** FLOP *** [6c Td 4s]
kadoboy21: checks 
astca: checks 
*** TURN *** [6c Td 4s] [8h]
kadoboy21: bets $0.06
astca: folds 
Uncalled bet ($0.06) returned to kadoboy21
kadoboy21 collected $0.15 from pot
*** SUMMARY ***
Total pot $0.16 | Rake $0.01 
Board [6c Td 4s 8h]
Seat 1: EderAmarilla folded before Flop (didn't bet)
Seat 2: 8AndreM9 (button) folded before Flop (didn't bet)
Seat 3: kadoboy21 (small blind) collected ($0.15)
Seat 4: 19dave72 (big blind) folded before Flop
Seat 5: Lorpugo folded before Flop (didn't bet)
Seat 6: astca folded on the Turn



PokerStars Hand #240733655808:  Hold'em No Limit ($0.01/$0.02 USD) - 2022/12/27 15:17:14 ET
Table 'Ilsebill' 6-max Seat #3 is the button
Seat 1: EderAmarilla ($2.44 in chips) 
Seat 2: 8AndreM9 ($2.74 in chips) 
Seat 3: kadoboy21 ($1.95 in chips) 
Seat 4: 19dave72 ($2.30 in chips) 
Seat 5: Lorpugo ($1.41 in chips) 
Seat 6: astca ($1.16 in chips) 
19dave72: posts small blind $0.01
Lorpugo: posts big blind $0.02
*** HOLE CARDS ***
Dealt to Lorpugo [3c 3d]
astca has timed out
astca: folds 
EderAmarilla: folds 
8AndreM9: folds 
kadoboy21: folds 
19dave72: folds 
Uncalled bet ($0.01) returned to Lorpugo
Lorpugo collected $0.02 from pot
Lorpugo: doesn't show hand 
*** SUMMARY ***
Total pot $0.02 | Rake $0 
Seat 1: EderAmarilla folded before Flop (didn't bet)
Seat 2: 8AndreM9 folded before Flop (didn't bet)
Seat 3: kadoboy21 (button) folded before Flop (didn't bet)
Seat 4: 19dave72 (small blind) folded before Flop
Seat 5: Lorpugo (big blind) collected ($0.02)
Seat 6: astca folded before Flop (didn't bet)



PokerStars Hand #240733663775:  Hold'em No Limit ($0.01/$0.02 USD) - 2022/12/27 15:17:31 ET
Table 'Ilsebill' 6-max Seat #4 is the button
Seat 1: EderAmarilla ($2.44 in chips) 
Seat 2: 8AndreM9 ($2.74 in chips) 
Seat 3: kadoboy21 ($1.95 in chips) 
Seat 4: 19dave72 ($2.29 in chips) 
Seat 5: Lorpugo ($1.42 in chips) 
Lorpugo: posts small blind $0.01
EderAmarilla: posts big blind $0.02
*** HOLE CARDS ***
Dealt to Lorpugo [Tc Ac]
8AndreM9: folds 
kadoboy21: calls $0.02
19dave72: folds 
Lorpugo: raises $0.06 to $0.08
EderAmarilla: folds 
kadoboy21: folds 
Uncalled bet ($0.06) returned to Lorpugo
Lorpugo collected $0.06 from pot
Lorpugo: doesn't show hand 
*** SUMMARY ***
Total pot $0.06 | Rake $0 
Seat 1: EderAmarilla (big blind) folded before Flop
Seat 2: 8AndreM9 folded before Flop (didn't bet)
Seat 3: kadoboy21 folded before Flop
Seat 4: 19dave72 (button) folded before Flop (didn't bet)
Seat 5: Lorpugo (small blind) collected ($0.06)



PokerStars Hand #240733676458:  Hold'em No Limit ($0.01/$0.02 USD) - 2022/12/27 15:17:57 ET
Table 'Ilsebill' 6-max Seat #5 is the button
Seat 1: EderAmarilla ($2.42 in chips) 
Seat 2: 8AndreM9 ($2.74 in chips) 
Seat 3: kadoboy21 ($1.93 in chips) 
Seat 4: 19dave72 ($2.29 in chips) 
Seat 5: Lorpugo ($1.46 in chips) 
EderAmarilla: posts small blind $0.01
8AndreM9: posts big blind $0.02
*** HOLE CARDS ***
Dealt to Lorpugo [Td 3d]
kadoboy21: calls $0.02
19dave72: folds 
Lorpugo: folds 
EderAmarilla: folds 
8AndreM9: checks 
*** FLOP *** [4c 7d Qh]
8AndreM9: checks 
kadoboy21: checks 
*** TURN *** [4c 7d Qh] [7s]
8AndreM9: checks 
kadoboy21: checks 
*** RIVER *** [4c 7d Qh 7s] [7c]
8AndreM9: checks 
kadoboy21: checks 
*** SHOW DOWN ***
8AndreM9: shows [Ts 9s] (three of a kind, Sevens)
kadoboy21: mucks hand 
8AndreM9 collected $0.05 from pot
*** SUMMARY ***
Total pot $0.05 | Rake $0 
Board [4c 7d Qh 7s 7c]
Seat 1: EderAmarilla (small blind) folded before Flop
Seat 2: 8AndreM9 (big blind) showed [Ts 9s] and won ($0.05) with three of a kind, Sevens
Seat 3: kadoboy21 mucked [6h 2h]
Seat 4: 19dave72 folded before Flop (didn't bet)
Seat 5: Lorpugo (button) folded before Flop (didn't bet)



PokerStars Hand #240733695601:  Hold'em No Limit ($0.01/$0.02 USD) - 2022/12/27 15:18:36 ET
Table 'Ilsebill' 6-max Seat #1 is the button
Seat 1: EderAmarilla ($2.41 in chips) 
Seat 2: 8AndreM9 ($2.77 in chips) 
Seat 3: kadoboy21 ($1.91 in chips) 
Seat 4: 19dave72 ($2.29 in chips) 
Seat 5: Lorpugo ($1.46 in chips) 
Seat 6: astca ($1.16 in chips) 
8AndreM9: posts small blind $0.01
kadoboy21: posts big blind $0.02
astca: posts small & big blinds $0.03
*** HOLE CARDS ***
Dealt to Lorpugo [Qc Kd]
19dave72: folds 
Lorpugo: raises $0.08 to $0.10
astca: raises $0.24 to $0.34
EderAmarilla: folds 
8AndreM9: folds 
kadoboy21: raises $0.24 to $0.58
Lorpugo: folds 
astca: raises $0.57 to $1.15 and is all-in
kadoboy21: calls $0.57
*** FLOP *** [Ad Qs 2c]
*** TURN *** [Ad Qs 2c] [7c]
*** RIVER *** [Ad Qs 2c 7c] [Js]
*** SHOW DOWN ***
kadoboy21: shows [7s 7d] (three of a kind, Sevens)
astca: shows [6h 6c] (a pair of Sixes)
kadoboy21 collected $2.34 from pot
astca cashed out the hand for $0.44
*** SUMMARY ***
Total pot $2.42 | Rake $0.08 
Board [Ad Qs 2c 7c Js]
Seat 1: EderAmarilla (button) folded before Flop (didn't bet)
Seat 2: 8AndreM9 (small blind) folded before Flop
Seat 3: kadoboy21 (big blind) showed [7s 7d] and won ($2.34) with three of a kind, Sevens
Seat 4: 19dave72 folded before Flop (didn't bet)
Seat 5: Lorpugo folded before Flop
Seat 6: astca showed [6h 6c] and lost with a pair of Sixes (cashed out).



PokerStars Hand #240733716111:  Hold'em No Limit ($0.01/$0.02 USD) - 2022/12/27 15:19:19 ET
Table 'Ilsebill' 6-max Seat #2 is the button
Seat 1: EderAmarilla ($2.41 in chips) 
Seat 2: 8AndreM9 ($2.76 in chips) 
Seat 3: kadoboy21 ($3.10 in chips) 
Seat 4: 19dave72 ($2.29 in chips) 
Seat 5: Lorpugo ($1.36 in chips) 
Seat 6: astca ($0.44 in chips) 
kadoboy21: posts small blind $0.01
19dave72: posts big blind $0.02
*** HOLE CARDS ***
Dealt to Lorpugo [8h 4c]
Lorpugo: folds 
astca: folds 
EderAmarilla: raises $0.04 to $0.06
8AndreM9: folds 
kadoboy21: folds 
19dave72: folds 
Uncalled bet ($0.04) returned to EderAmarilla
EderAmarilla collected $0.05 from pot
EderAmarilla: doesn't show hand 
*** SUMMARY ***
Total pot $0.05 | Rake $0 
Seat 1: EderAmarilla collected ($0.05)
Seat 2: 8AndreM9 (button) folded before Flop (didn't bet)
Seat 3: kadoboy21 (small blind) folded before Flop
Seat 4: 19dave72 (big blind) folded before Flop
Seat 5: Lorpugo folded before Flop (didn't bet)
Seat 6: astca folded before Flop (didn't bet)



PokerStars Hand #240733725203:  Hold'em No Limit ($0.01/$0.02 USD) - 2022/12/27 15:19:38 ET
Table 'Ilsebill' 6-max Seat #3 is the button
Seat 1: EderAmarilla ($2.44 in chips) 
Seat 2: 8AndreM9 ($2.76 in chips) 
Seat 3: kadoboy21 ($3.09 in chips) 
Seat 4: 19dave72 ($2.27 in chips) 
Seat 5: Lorpugo ($1.36 in chips) 
Seat 6: astca ($0.44 in chips) 
19dave72: posts small blind $0.01
Lorpugo: posts big blind $0.02
*** HOLE CARDS ***
Dealt to Lorpugo [Kd Jc]
astca: folds 
EderAmarilla: folds 
8AndreM9: folds 
kadoboy21: calls $0.02
19dave72: folds 
Lorpugo: raises $0.05 to $0.07
kadoboy21: folds 
Uncalled bet ($0.05) returned to Lorpugo
Lorpugo collected $0.05 from pot
Lorpugo: doesn't show hand 
*** SUMMARY ***
Total pot $0.05 | Rake $0 
Seat 1: EderAmarilla folded before Flop (didn't bet)
Seat 2: 8AndreM9 folded before Flop (didn't bet)
Seat 3: kadoboy21 (button) folded before Flop
Seat 4: 19dave72 (small blind) folded before Flop
Seat 5: Lorpugo (big blind) collected ($0.05)
Seat 6: astca folded before Flop (didn't bet)



PokerStars Hand #240733738744:  Hold'em No Limit ($0.01/$0.02 USD) - 2022/12/27 15:20:06 ET
Table 'Ilsebill' 6-max Seat #4 is the button
Seat 1: EderAmarilla ($2.44 in chips) 
Seat 2: 8AndreM9 ($2.76 in chips) 
Seat 3: kadoboy21 ($3.07 in chips) 
Seat 4: 19dave72 ($2.26 in chips) 
Seat 5: Lorpugo ($1.39 in chips) 
Seat 6: astca ($0.44 in chips) 
Lorpugo: posts small blind $0.01
astca: posts big blind $0.02
*** HOLE CARDS ***
Dealt to Lorpugo [4s 7s]
EderAmarilla: folds 
8AndreM9: calls $0.02
kadoboy21: folds 
19dave72: folds 
Lorpugo: calls $0.01
astca: raises $0.06 to $0.08
8AndreM9: calls $0.06
Lorpugo: folds 
*** FLOP *** [7h Ts 3d]
astca: checks 
8AndreM9: bets $0.09
astca: folds 
Uncalled bet ($0.09) returned to 8AndreM9
8AndreM9 collected $0.17 from pot
*** SUMMARY ***
Total pot $0.18 | Rake $0.01 
Board [7h Ts 3d]
Seat 1: EderAmarilla folded before Flop (didn't bet)
Seat 2: 8AndreM9 collected ($0.17)
Seat 3: kadoboy21 folded before Flop (didn't bet)
Seat 4: 19dave72 (button) folded before Flop (didn't bet)
Seat 5: Lorpugo (small blind) folded before Flop
Seat 6: astca (big blind) folded on the Flop



PokerStars Hand #240733753493:  Hold'em No Limit ($0.01/$0.02 USD) - 2022/12/27 15:20:36 ET
Table 'Ilsebill' 6-max Seat #5 is the button
Seat 1: EderAmarilla ($2.44 in chips) 
Seat 2: 8AndreM9 ($2.85 in chips) 
Seat 3: kadoboy21 ($3.07 in chips) 
Seat 4: 19dave72 ($2.26 in chips) 
Seat 5: Lorpugo ($1.37 in chips) 
Seat 6: astca ($0.36 in chips) 
astca: posts small blind $0.01
EderAmarilla: posts big blind $0.02
*** HOLE CARDS ***
Dealt to Lorpugo [4h 6c]
8AndreM9: folds 
kadoboy21: calls $0.02
19dave72: folds 
Lorpugo: folds 
astca: raises $0.06 to $0.08
EderAmarilla: folds 
kadoboy21: calls $0.06
*** FLOP *** [6h 5c 9d]
astca: bets $0.17
kadoboy21: raises $0.17 to $0.34
astca: calls $0.11 and is all-in
Uncalled bet ($0.06) returned to kadoboy21
*** TURN *** [6h 5c 9d] [3d]
*** RIVER *** [6h 5c 9d 3d] [Kc]
*** SHOW DOWN ***
astca: shows [Th 9c] (a pair of Nines)
kadoboy21: shows [Ts 5h] (a pair of Fives)
astca collected $0.71 from pot
*** SUMMARY ***
Total pot $0.74 | Rake $0.03 
Board [6h 5c 9d 3d Kc]
Seat 1: EderAmarilla (big blind) folded before Flop
Seat 2: 8AndreM9 folded before Flop (didn't bet)
Seat 3: kadoboy21 showed [Ts 5h] and lost with a pair of Fives
Seat 4: 19dave72 folded before Flop (didn't bet)
Seat 5: Lorpugo (button) folded before Flop (didn't bet)
Seat 6: astca (small blind) showed [Th 9c] and won ($0.71) with a pair of Nines



PokerStars Hand #240733779417:  Hold'em No Limit ($0.01/$0.02 USD) - 2022/12/27 15:21:29 ET
Table 'Ilsebill' 6-max Seat #6 is the button
Seat 1: EderAmarilla ($2.42 in chips) 
Seat 2: 8AndreM9 ($2.85 in chips) 
Seat 3: kadoboy21 ($2.71 in chips) 
Seat 4: 19dave72 ($2.26 in chips) 
Seat 5: Lorpugo ($1.37 in chips) 
Seat 6: astca ($0.71 in chips) 
EderAmarilla: posts small blind $0.01
8AndreM9: posts big blind $0.02
*** HOLE CARDS ***
Dealt to Lorpugo [4s 2h]
kadoboy21: folds 
19dave72: folds 
Lorpugo: folds 
astca: folds 
EderAmarilla: folds 
Uncalled bet ($0.01) returned to 8AndreM9
8AndreM9 collected $0.02 from pot
*** SUMMARY ***
Total pot $0.02 | Rake $0 
Seat 1: EderAmarilla (small blind) folded before Flop
Seat 2: 8AndreM9 (big blind) collected ($0.02)
Seat 3: kadoboy21 folded before Flop (didn't bet)
Seat 4: 19dave72 folded before Flop (didn't bet)
Seat 5: Lorpugo folded before Flop (didn't bet)
Seat 6: astca (button) folded before Flop (didn't bet)



PokerStars Hand #240733794974:  Hold'em No Limit ($0.01/$0.02 USD) - 2022/12/27 15:22:02 ET
Table 'Ilsebill' 6-max Seat #1 is the button
Seat 1: EderAmarilla ($2.41 in chips) 
Seat 2: 8AndreM9 ($2.86 in chips) 
Seat 3: kadoboy21 ($2.71 in chips) 
Seat 4: 19dave72 ($2.26 in chips) 
Seat 5: Lorpugo ($1.37 in chips) 
Seat 6: astca ($0.71 in chips) 
8AndreM9: posts small blind $0.01
kadoboy21: posts big blind $0.02
*** HOLE CARDS ***
Dealt to Lorpugo [7c 2s]
19dave72: folds 
Lorpugo: folds 
astca: calls $0.02
EderAmarilla: folds 
8AndreM9: folds 
kadoboy21: checks 
*** FLOP *** [Ts 5h 8c]
kadoboy21: checks 
astca: checks 
*** TURN *** [Ts 5h 8c] [Qc]
kadoboy21: checks 
astca: bets $0.03
kadoboy21: folds 
Uncalled bet ($0.03) returned to astca
astca collected $0.05 from pot
*** SUMMARY ***
Total pot $0.05 | Rake $0 
Board [Ts 5h 8c Qc]
Seat 1: EderAmarilla (button) folded before Flop (didn't bet)
Seat 2: 8AndreM9 (small blind) folded before Flop
Seat 3: kadoboy21 (big blind) folded on the Turn
Seat 4: 19dave72 folded before Flop (didn't bet)
Seat 5: Lorpugo folded before Flop (didn't bet)
Seat 6: astca collected ($0.05)



PokerStars Hand #240733808311:  Hold'em No Limit ($0.01/$0.02 USD) - 2022/12/27 15:22:29 ET
Table 'Ilsebill' 6-max Seat #2 is the button
Seat 1: EderAmarilla ($2.41 in chips) 
Seat 2: 8AndreM9 ($2.85 in chips) 
Seat 3: kadoboy21 ($2.69 in chips) 
Seat 4: 19dave72 ($2.26 in chips) 
Seat 5: Lorpugo ($1.37 in chips) 
Seat 6: astca ($0.74 in chips) 
kadoboy21: posts small blind $0.01
19dave72: posts big blind $0.02
*** HOLE CARDS ***
Dealt to Lorpugo [9d 6d]
Lorpugo: folds 
astca: folds 
EderAmarilla has timed out
EderAmarilla: folds 
8AndreM9: calls $0.02
kadoboy21: calls $0.01
19dave72: checks 
*** FLOP *** [Td 2s 2h]
kadoboy21: checks 
19dave72: checks 
8AndreM9: checks 
*** TURN *** [Td 2s 2h] [Qd]
EderAmarilla leaves the table
kadoboy21: checks 
19dave72: checks 
8AndreM9: checks 
*** RIVER *** [Td 2s 2h Qd] [Ks]
VillDimo joins the table at seat #1 
kadoboy21: checks 
19dave72: checks 
8AndreM9: checks 
*** SHOW DOWN ***
kadoboy21: shows [Ah 7s] (a pair of Deuces)
19dave72: shows [4h Ad] (a pair of Deuces)
8AndreM9: mucks hand 
kadoboy21 collected $0.03 from pot
19dave72 collected $0.03 from pot
*** SUMMARY ***
Total pot $0.06 | Rake $0 
Board [Td 2s 2h Qd Ks]
Seat 1: EderAmarilla folded before Flop (didn't bet)
Seat 2: 8AndreM9 (button) mucked [6c 9h]
Seat 3: kadoboy21 (small blind) showed [Ah 7s] and won ($0.03) with a pair of Deuces
Seat 4: 19dave72 (big blind) showed [4h Ad] and won ($0.03) with a pair of Deuces
Seat 5: Lorpugo folded before Flop (didn't bet)
Seat 6: astca folded before Flop (didn't bet)



PokerStars Hand #240733830900:  Hold'em No Limit ($0.01/$0.02 USD) - 2022/12/27 15:23:17 ET
Table 'Ilsebill' 6-max Seat #3 is the button
Seat 2: 8AndreM9 ($2.83 in chips) 
Seat 3: kadoboy21 ($2.70 in chips) 
Seat 4: 19dave72 ($2.27 in chips) 
Seat 5: Lorpugo ($1.37 in chips) 
Seat 6: astca ($0.74 in chips) 
19dave72: posts small blind $0.01
Lorpugo: posts big blind $0.02
*** HOLE CARDS ***
Dealt to Lorpugo [5d 7d]
astca: folds 
8AndreM9: calls $0.02
kadoboy21: calls $0.02
19dave72: folds 
Lorpugo: checks 
*** FLOP *** [Td 9d Kd]
Lorpugo: checks 
8AndreM9: checks 
kadoboy21: checks 
*** TURN *** [Td 9d Kd] [5h]
Lorpugo: bets $0.07
8AndreM9: folds 
kadoboy21: calls $0.07
*** RIVER *** [Td 9d Kd 5h] [Ah]
Lorpugo: bets $0.20
kadoboy21: folds 
Uncalled bet ($0.20) returned to Lorpugo
Lorpugo collected $0.20 from pot
Lorpugo: doesn't show hand 
*** SUMMARY ***
Total pot $0.21 | Rake $0.01 
Board [Td 9d Kd 5h Ah]
Seat 2: 8AndreM9 folded on the Turn
Seat 3: kadoboy21 (button) folded on the River
Seat 4: 19dave72 (small blind) folded before Flop
Seat 5: Lorpugo (big blind) collected ($0.20)
Seat 6: astca folded before Flop (didn't bet)



PokerStars Hand #240733859521:  Hold'em No Limit ($0.01/$0.02 USD) - 2022/12/27 15:24:16 ET
Table 'Ilsebill' 6-max Seat #4 is the button
Seat 2: 8AndreM9 ($2.81 in chips) 
Seat 3: kadoboy21 ($2.61 in chips) 
Seat 4: 19dave72 ($2.26 in chips) 
Seat 5: Lorpugo ($1.48 in chips) 
Seat 6: astca ($0.74 in chips) 
Lorpugo: posts small blind $0.01
astca: posts big blind $0.02
*** HOLE CARDS ***
Dealt to Lorpugo [8d 2s]
8AndreM9: folds 
kadoboy21 is disconnected 
kadoboy21 has timed out while disconnected
kadoboy21: folds 
19dave72: folds 
Lorpugo: folds 
Uncalled bet ($0.01) returned to astca
astca collected $0.02 from pot
*** SUMMARY ***
Total pot $0.02 | Rake $0 
Seat 2: 8AndreM9 folded before Flop (didn't bet)
Seat 3: kadoboy21 folded before Flop (didn't bet)
Seat 4: 19dave72 (button) folded before Flop (didn't bet)
Seat 5: Lorpugo (small blind) folded before Flop
Seat 6: astca (big blind) collected ($0.02)



PokerStars Hand #240733868724:  Hold'em No Limit ($0.01/$0.02 USD) - 2022/12/27 15:24:35 ET
Table 'Ilsebill' 6-max Seat #5 is the button
Seat 1: VillDimo ($2 in chips) 
Seat 2: 8AndreM9 ($2.81 in chips) 
Seat 4: 19dave72 ($2.26 in chips) 
Seat 5: Lorpugo ($1.47 in chips) 
Seat 6: astca ($0.75 in chips) 
astca: posts small blind $0.01
VillDimo: posts big blind $0.02
*** HOLE CARDS ***
Dealt to Lorpugo [Td 7c]
8AndreM9: calls $0.02
19dave72: folds 
Lorpugo: folds 
astca: calls $0.01
VillDimo: checks 
*** FLOP *** [9s Ad 8d]
astca: checks 
VillDimo: checks 
8AndreM9: bets $0.03
astca: folds 
VillDimo: folds 
Uncalled bet ($0.03) returned to 8AndreM9
8AndreM9 collected $0.06 from pot
*** SUMMARY ***
Total pot $0.06 | Rake $0 
Board [9s Ad 8d]
Seat 1: VillDimo (big blind) folded on the Flop
Seat 2: 8AndreM9 collected ($0.06)
Seat 4: 19dave72 folded before Flop (didn't bet)
Seat 5: Lorpugo (button) folded before Flop (didn't bet)
Seat 6: astca (small blind) folded on the Flop



PokerStars Hand #240733883184:  Hold'em No Limit ($0.01/$0.02 USD) - 2022/12/27 15:25:05 ET
Table 'Ilsebill' 6-max Seat #6 is the button
Seat 1: VillDimo ($2 in chips) 
Seat 2: 8AndreM9 ($2.85 in chips) 
Seat 4: 19dave72 ($2.26 in chips) 
Seat 5: Lorpugo ($1.47 in chips) 
Seat 6: astca ($0.73 in chips) 
VillDimo: posts small blind $0.01
8AndreM9: posts big blind $0.02
*** HOLE CARDS ***
Dealt to Lorpugo [7c 6s]
19dave72: folds 
Lorpugo: folds 
astca: raises $0.04 to $0.06
VillDimo: folds 
8AndreM9: calls $0.04
*** FLOP *** [Jc Ks Ac]
8AndreM9: checks 
astca: bets $0.13
8AndreM9: calls $0.13
*** TURN *** [Jc Ks Ac] [5h]
8AndreM9: checks 
astca: checks 
*** RIVER *** [Jc Ks Ac 5h] [6c]
8AndreM9: checks 
astca: checks 
*** SHOW DOWN ***
8AndreM9: shows [Jd Th] (a pair of Jacks)
astca: mucks hand 
8AndreM9 collected $0.38 from pot
*** SUMMARY ***
Total pot $0.39 | Rake $0.01 
Board [Jc Ks Ac 5h 6c]
Seat 1: VillDimo (small blind) folded before Flop
Seat 2: 8AndreM9 (big blind) showed [Jd Th] and won ($0.38) with a pair of Jacks
Seat 4: 19dave72 folded before Flop (didn't bet)
Seat 5: Lorpugo folded before Flop (didn't bet)
Seat 6: astca (button) mucked [2s Qs]



PokerStars Hand #240733902858:  Hold'em No Limit ($0.01/$0.02 USD) - 2022/12/27 15:25:46 ET
Table 'Ilsebill' 6-max Seat #1 is the button
Seat 1: VillDimo ($2 in chips) 
Seat 2: 8AndreM9 ($3.04 in chips) 
Seat 4: 19dave72 ($2.26 in chips) 
Seat 5: Lorpugo ($1.47 in chips) 
Seat 6: astca ($0.54 in chips) 
8AndreM9: posts small blind $0.01
19dave72: posts big blind $0.02
*** HOLE CARDS ***
Dealt to Lorpugo [8c Jd]
Lorpugo: folds 
astca: folds 
VillDimo: folds 
8AndreM9: calls $0.01
19dave72: checks 
*** FLOP *** [3c 7c 2s]
8AndreM9: checks 
19dave72: checks 
*** TURN *** [3c 7c 2s] [Ad]
8AndreM9: checks 
19dave72: checks 
*** RIVER *** [3c 7c 2s Ad] [2h]
8AndreM9: checks 
19dave72: checks 
*** SHOW DOWN ***
8AndreM9: shows [9h 6d] (a pair of Deuces)
19dave72: shows [9d 5d] (a pair of Deuces)
8AndreM9 collected $0.02 from pot
19dave72 collected $0.02 from pot
*** SUMMARY ***
Total pot $0.04 | Rake $0 
Board [3c 7c 2s Ad 2h]
Seat 1: VillDimo (button) folded before Flop (didn't bet)
Seat 2: 8AndreM9 (small blind) showed [9h 6d] and won ($0.02) with a pair of Deuces
Seat 4: 19dave72 (big blind) showed [9d 5d] and won ($0.02) with a pair of Deuces
Seat 5: Lorpugo folded before Flop (didn't bet)
Seat 6: astca folded before Flop (didn't bet)



PokerStars Hand #240733916654:  Hold'em No Limit ($0.01/$0.02 USD) - 2022/12/27 15:26:15 ET
Table 'Ilsebill' 6-max Seat #2 is the button
Seat 1: VillDimo ($2 in chips) 
Seat 2: 8AndreM9 ($3.04 in chips) 
Seat 4: 19dave72 ($2.26 in chips) 
Seat 5: Lorpugo ($1.47 in chips) 
Seat 6: astca ($0.54 in chips) 
19dave72: posts small blind $0.01
Lorpugo: posts big blind $0.02
*** HOLE CARDS ***
Dealt to Lorpugo [3c Jd]
astca has timed out
astca: folds 
VillDimo: folds 
8AndreM9: raises $0.08 to $0.10
19dave72: folds 
Lorpugo: folds 
Uncalled bet ($0.08) returned to 8AndreM9
8AndreM9 collected $0.05 from pot
*** SUMMARY ***
Total pot $0.05 | Rake $0 
Seat 1: VillDimo folded before Flop (didn't bet)
Seat 2: 8AndreM9 (button) collected ($0.05)
Seat 4: 19dave72 (small blind) folded before Flop
Seat 5: Lorpugo (big blind) folded before Flop
Seat 6: astca folded before Flop (didn't bet)



PokerStars Hand #240733928097:  Hold'em No Limit ($0.01/$0.02 USD) - 2022/12/27 15:26:38 ET
Table 'Ilsebill' 6-max Seat #4 is the button
Seat 1: VillDimo ($2 in chips) 
Seat 2: 8AndreM9 ($3.07 in chips) 
Seat 4: 19dave72 ($2.25 in chips) 
Seat 5: Lorpugo ($1.45 in chips) 
Seat 6: astca ($0.54 in chips) 
Lorpugo: posts small blind $0.01
astca: posts big blind $0.02
*** HOLE CARDS ***
Dealt to Lorpugo [Qd 5d]
VillDimo: folds 
8AndreM9: folds 
19dave72: raises $0.04 to $0.06
Lorpugo: folds 
astca: folds 
Uncalled bet ($0.04) returned to 19dave72
19dave72 collected $0.05 from pot
19dave72: doesn't show hand 
*** SUMMARY ***
Total pot $0.05 | Rake $0 
Seat 1: VillDimo folded before Flop (didn't bet)
Seat 2: 8AndreM9 folded before Flop (didn't bet)
Seat 4: 19dave72 (button) collected ($0.05)
Seat 5: Lorpugo (small blind) folded before Flop
Seat 6: astca (big blind) folded before Flop



PokerStars Hand #240733936288:  Hold'em No Limit ($0.01/$0.02 USD) - 2022/12/27 15:26:56 ET
Table 'Ilsebill' 6-max Seat #5 is the button
Seat 1: VillDimo ($2 in chips) 
Seat 2: 8AndreM9 ($3.07 in chips) 
Seat 4: 19dave72 ($2.28 in chips) 
Seat 5: Lorpugo ($1.44 in chips) 
Seat 6: astca ($0.52 in chips) 
astca: posts small blind $0.01
VillDimo: posts big blind $0.02
*** HOLE CARDS ***
Dealt to Lorpugo [6c Ac]
8AndreM9: folds 
19dave72: raises $0.04 to $0.06
Lorpugo: calls $0.06
astca has timed out
astca: folds 
VillDimo: folds 
*** FLOP *** [8c Jc 9d]
19dave72: checks 
Lorpugo: bets $0.09
19dave72: calls $0.09
*** TURN *** [8c Jc 9d] [4d]
19dave72: checks 
Lorpugo: bets $0.21
19dave72: folds 
Uncalled bet ($0.21) returned to Lorpugo
Lorpugo collected $0.32 from pot
Lorpugo: doesn't show hand 
*** SUMMARY ***
Total pot $0.33 | Rake $0.01 
Board [8c Jc 9d 4d]
Seat 1: VillDimo (big blind) folded before Flop
Seat 2: 8AndreM9 folded before Flop (didn't bet)
Seat 4: 19dave72 folded on the Turn
Seat 5: Lorpugo (button) collected ($0.32)
Seat 6: astca (small blind) folded before Flop



PokerStars Hand #240733976537:  Hold'em No Limit ($0.01/$0.02 USD) - 2022/12/27 15:28:19 ET
Table 'Ilsebill' 6-max Seat #6 is the button
Seat 1: VillDimo ($2 in chips) 
Seat 2: 8AndreM9 ($3.07 in chips) 
Seat 4: 19dave72 ($2.13 in chips) 
Seat 5: Lorpugo ($1.61 in chips) 
Seat 6: astca ($0.51 in chips) 
VillDimo: posts small blind $0.01
8AndreM9: posts big blind $0.02
*** HOLE CARDS ***
Dealt to Lorpugo [8c 5d]
19dave72: folds 
Lorpugo: folds 
astca: folds 
VillDimo: raises $0.04 to $0.06
8AndreM9: calls $0.04
*** FLOP *** [7c Ks 6c]
VillDimo: bets $0.06
8AndreM9: folds 
Uncalled bet ($0.06) returned to VillDimo
VillDimo collected $0.12 from pot
*** SUMMARY ***
Total pot $0.12 | Rake $0 
Board [7c Ks 6c]
Seat 1: VillDimo (small blind) collected ($0.12)
Seat 2: 8AndreM9 (big blind) folded on the Flop
Seat 4: 19dave72 folded before Flop (didn't bet)
Seat 5: Lorpugo folded before Flop (didn't bet)
Seat 6: astca (button) folded before Flop (didn't bet)



PokerStars Hand #240733985519:  Hold'em No Limit ($0.01/$0.02 USD) - 2022/12/27 15:28:38 ET
Table 'Ilsebill' 6-max Seat #1 is the button
Seat 1: VillDimo ($2.06 in chips) 
Seat 2: 8AndreM9 ($3.01 in chips) 
Seat 4: 19dave72 ($2.13 in chips) 
Seat 5: Lorpugo ($1.61 in chips) 
Seat 6: astca ($0.51 in chips) 
8AndreM9: posts small blind $0.01
19dave72: posts big blind $0.02
*** HOLE CARDS ***
Dealt to Lorpugo [Jd 5h]
Lorpugo: folds 
astca: raises $0.05 to $0.07
VillDimo: folds 
8AndreM9: folds 
19dave72: folds 
Uncalled bet ($0.05) returned to astca
astca collected $0.05 from pot
*** SUMMARY ***
Total pot $0.05 | Rake $0 
Seat 1: VillDimo (button) folded before Flop (didn't bet)
Seat 2: 8AndreM9 (small blind) folded before Flop
Seat 4: 19dave72 (big blind) folded before Flop
Seat 5: Lorpugo folded before Flop (didn't bet)
Seat 6: astca collected ($0.05)



PokerStars Hand #240733992162:  Hold'em No Limit ($0.01/$0.02 USD) - 2022/12/27 15:28:52 ET
Table 'Ilsebill' 6-max Seat #2 is the button
Seat 1: VillDimo ($2.06 in chips) 
Seat 2: 8AndreM9 ($3 in chips) 
Seat 4: 19dave72 ($2.11 in chips) 
Seat 5: Lorpugo ($1.61 in chips) 
Seat 6: astca ($0.54 in chips) 
19dave72: posts small blind $0.01
Lorpugo: posts big blind $0.02
*** HOLE CARDS ***
Dealt to Lorpugo [2h 9d]
astca: folds 
VillDimo: raises $0.04 to $0.06
8AndreM9: calls $0.06
19dave72: folds 
Lorpugo: folds 
*** FLOP *** [9s 6c 6s]
VillDimo: checks 
8AndreM9: checks 
*** TURN *** [9s 6c 6s] [8s]
VillDimo: checks 
8AndreM9: checks 
*** RIVER *** [9s 6c 6s 8s] [Qd]
VillDimo: checks 
8AndreM9: checks 
*** SHOW DOWN ***
VillDimo: shows [Ac Kc] (a pair of Sixes)
8AndreM9: shows [Tc Qh] (two pair, Queens and Sixes)
8AndreM9 collected $0.14 from pot
*** SUMMARY ***
Total pot $0.15 | Rake $0.01 
Board [9s 6c 6s 8s Qd]
Seat 1: VillDimo showed [Ac Kc] and lost with a pair of Sixes
Seat 2: 8AndreM9 (button) showed [Tc Qh] and won ($0.14) with two pair, Queens and Sixes
Seat 4: 19dave72 (small blind) folded before Flop
Seat 5: Lorpugo (big blind) folded before Flop
Seat 6: astca folded before Flop (didn't bet)



PokerStars Hand #240734013067:  Hold'em No Limit ($0.01/$0.02 USD) - 2022/12/27 15:29:35 ET
Table 'Ilsebill' 6-max Seat #4 is the button
Seat 1: VillDimo ($2 in chips) 
Seat 2: 8AndreM9 ($3.08 in chips) 
Seat 4: 19dave72 ($2.10 in chips) 
Seat 5: Lorpugo ($1.59 in chips) 
Seat 6: astca ($0.54 in chips) 
Lorpugo: posts small blind $0.01
astca: posts big blind $0.02
*** HOLE CARDS ***
Dealt to Lorpugo [8c 8s]
VillDimo: folds 
8AndreM9: calls $0.02
19dave72: raises $0.06 to $0.08
Lorpugo: calls $0.07
astca: folds 
8AndreM9: calls $0.06
*** FLOP *** [5s 7d Js]
Lorpugo: checks 
8AndreM9: checks 
19dave72: bets $0.16
Lorpugo: calls $0.16
8AndreM9: folds 
*** TURN *** [5s 7d Js] [Qh]
Lorpugo: checks 
19dave72: checks 
*** RIVER *** [5s 7d Js Qh] [Ac]
Lorpugo: checks 
19dave72: checks 
*** SHOW DOWN ***
Lorpugo: shows [8c 8s] (a pair of Eights)
19dave72: shows [Th Jh] (a pair of Jacks)
19dave72 collected $0.56 from pot
*** SUMMARY ***
Total pot $0.58 | Rake $0.02 
Board [5s 7d Js Qh Ac]
Seat 1: VillDimo folded before Flop (didn't bet)
Seat 2: 8AndreM9 folded on the Flop
Seat 4: 19dave72 (button) showed [Th Jh] and won ($0.56) with a pair of Jacks
Seat 5: Lorpugo (small blind) showed [8c 8s] and lost with a pair of Eights
Seat 6: astca (big blind) folded before Flop



PokerStars Hand #240734035762:  Hold'em No Limit ($0.01/$0.02 USD) - 2022/12/27 15:30:22 ET
Table 'Ilsebill' 6-max Seat #5 is the button
Seat 1: VillDimo ($2 in chips) 
Seat 2: 8AndreM9 ($3 in chips) 
Seat 4: 19dave72 ($2.42 in chips) 
Seat 5: Lorpugo ($1.35 in chips) 
Seat 6: astca ($0.52 in chips) 
astca: posts small blind $0.01
VillDimo: posts big blind $0.02
*** HOLE CARDS ***
Dealt to Lorpugo [Qd 4c]
8AndreM9: folds 
8AndreM9 leaves the table
19dave72: raises $0.04 to $0.06
Lorpugo: folds 
Keremsen88 joins the table at seat #2 
astca has timed out
astca: folds 
VillDimo: folds 
Uncalled bet ($0.04) returned to 19dave72
19dave72 collected $0.05 from pot
19dave72: doesn't show hand 
*** SUMMARY ***
Total pot $0.05 | Rake $0 
Seat 1: VillDimo (big blind) folded before Flop
Seat 2: 8AndreM9 folded before Flop (didn't bet)
Seat 4: 19dave72 collected ($0.05)
Seat 5: Lorpugo (button) folded before Flop (didn't bet)
Seat 6: astca (small blind) folded before Flop



PokerStars Hand #240734048623:  Hold'em No Limit ($0.01/$0.02 USD) - 2022/12/27 15:30:49 ET
Table 'Ilsebill' 6-max Seat #1 is the button
Seat 1: VillDimo ($2 in chips) 
Seat 4: 19dave72 ($2.45 in chips) 
Seat 5: Lorpugo ($1.35 in chips) 
19dave72: posts small blind $0.01
Lorpugo: posts big blind $0.02
*** HOLE CARDS ***
Dealt to Lorpugo [Ac 3c]
VillDimo: raises $0.04 to $0.06
19dave72: folds 
Lorpugo: calls $0.04
*** FLOP *** [4s Tc 4c]
Lorpugo: checks 
VillDimo: bets $0.06
Lorpugo: raises $1.23 to $1.29 and is all-in
VillDimo: folds 
Uncalled bet ($1.23) returned to Lorpugo
Lorpugo collected $0.24 from pot
Lorpugo: doesn't show hand 
*** SUMMARY ***
Total pot $0.25 | Rake $0.01 
Board [4s Tc 4c]
Seat 1: VillDimo (button) folded on the Flop
Seat 4: 19dave72 (small blind) folded before Flop
Seat 5: Lorpugo (big blind) collected ($0.24)



PokerStars Hand #240734065342:  Hold'em No Limit ($0.01/$0.02 USD) - 2022/12/27 15:31:23 ET
Table 'Ilsebill' 6-max Seat #4 is the button
Seat 1: VillDimo ($2 in chips) 
Seat 2: Keremsen88 ($1.60 in chips) 
Seat 4: 19dave72 ($2.44 in chips) 
Seat 5: Lorpugo ($1.47 in chips) 
Seat 6: astca ($0.51 in chips) 
Lorpugo: posts small blind $0.01
astca: posts big blind $0.02
Keremsen88: posts big blind $0.02
*** HOLE CARDS ***
Dealt to Lorpugo [Td 7s]
VillDimo: folds 
Keremsen88: checks 
19dave72: raises $0.06 to $0.08
Lorpugo: folds 
astca: calls $0.06
Keremsen88: folds 
*** FLOP *** [Qh 4s Ks]
astca: bets $0.09
19dave72: folds 
Uncalled bet ($0.09) returned to astca
astca collected $0.18 from pot
*** SUMMARY ***
Total pot $0.19 | Rake $0.01 
Board [Qh 4s Ks]
Seat 1: VillDimo folded before Flop (didn't bet)
Seat 2: Keremsen88 folded before Flop (didn't bet)
Seat 4: 19dave72 (button) folded on the Flop
Seat 5: Lorpugo (small blind) folded before Flop
Seat 6: astca (big blind) collected ($0.18)



PokerStars Hand #240734080056:  Hold'em No Limit ($0.01/$0.02 USD) - 2022/12/27 15:31:54 ET
Table 'Ilsebill' 6-max Seat #5 is the button
Seat 1: VillDimo ($2 in chips) 
Seat 2: Keremsen88 ($1.58 in chips) 
Seat 4: 19dave72 ($2.36 in chips) 
Seat 5: Lorpugo ($1.46 in chips) 
Seat 6: astca ($0.61 in chips) 
astca: posts small blind $0.01
VillDimo: posts big blind $0.02
*** HOLE CARDS ***
Dealt to Lorpugo [4c Kd]
Keremsen88: calls $0.02
19dave72: folds 
Lorpugo: folds 
astca: raises $0.06 to $0.08
VillDimo: folds 
Keremsen88: calls $0.06
*** FLOP *** [Tc Qd 7d]
astca: bets $0.09
Keremsen88: calls $0.09
*** TURN *** [Tc Qd 7d] [9s]
astca: bets $0.18
Keremsen88: calls $0.18
*** RIVER *** [Tc Qd 7d 9s] [9d]
astca: bets $0.26 and is all-in
Keremsen88: calls $0.26
*** SHOW DOWN ***
astca: shows [Kh Td] (two pair, Tens and Nines)
Keremsen88: shows [6d 5d] (a flush, Queen high)
Keremsen88 collected $1.19 from pot
*** SUMMARY ***
Total pot $1.24 | Rake $0.05 
Board [Tc Qd 7d 9s 9d]
Seat 1: VillDimo (big blind) folded before Flop
Seat 2: Keremsen88 showed [6d 5d] and won ($1.19) with a flush, Queen high
Seat 4: 19dave72 folded before Flop (didn't bet)
Seat 5: Lorpugo (button) folded before Flop (didn't bet)
Seat 6: astca (small blind) showed [Kh Td] and lost with two pair, Tens and Nines



PokerStars Hand #240734103744:  Hold'em No Limit ($0.01/$0.02 USD) - 2022/12/27 15:32:43 ET
Table 'Ilsebill' 6-max Seat #1 is the button
Seat 1: VillDimo ($2 in chips) 
Seat 2: Keremsen88 ($2.16 in chips) 
Seat 4: 19dave72 ($2.36 in chips) 
Seat 5: Lorpugo ($1.46 in chips) 
Keremsen88: posts small blind $0.01
19dave72: posts big blind $0.02
*** HOLE CARDS ***
Dealt to Lorpugo [Td 9c]
Lorpugo: raises $0.04 to $0.06
VillDimo: folds 
Keremsen88: raises $0.10 to $0.16
19dave72: folds 
Lorpugo: folds 
Uncalled bet ($0.10) returned to Keremsen88
Keremsen88 collected $0.14 from pot
kadoboy21 leaves the table
*** SUMMARY ***
Total pot $0.14 | Rake $0 
Seat 1: VillDimo (button) folded before Flop (didn't bet)
Seat 2: Keremsen88 (small blind) collected ($0.14)
Seat 4: 19dave72 (big blind) folded before Flop
Seat 5: Lorpugo folded before Flop



PokerStars Hand #240734112776:  Hold'em No Limit ($0.01/$0.02 USD) - 2022/12/27 15:33:01 ET
Table 'Ilsebill' 6-max Seat #2 is the button
Seat 1: VillDimo ($2 in chips) 
Seat 2: Keremsen88 ($2.24 in chips) 
Seat 4: 19dave72 ($2.34 in chips) 
Seat 5: Lorpugo ($1.40 in chips) 
19dave72: posts small blind $0.01
Lorpugo: posts big blind $0.02
*** HOLE CARDS ***
Dealt to Lorpugo [4h Js]
VillDimo: folds 
Keremsen88: folds 
19dave72: folds 
Uncalled bet ($0.01) returned to Lorpugo
Lorpugo collected $0.02 from pot
Lorpugo: doesn't show hand 
*** SUMMARY ***
Total pot $0.02 | Rake $0 
Seat 1: VillDimo folded before Flop (didn't bet)
Seat 2: Keremsen88 (button) folded before Flop (didn't bet)
Seat 4: 19dave72 (small blind) folded before Flop
Seat 5: Lorpugo (big blind) collected ($0.02)



PokerStars Hand #240734118633:  Hold'em No Limit ($0.01/$0.02 USD) - 2022/12/27 15:33:14 ET
Table 'Ilsebill' 6-max Seat #4 is the button
Seat 1: VillDimo ($2 in chips) 
Seat 2: Keremsen88 ($2.24 in chips) 
Seat 4: 19dave72 ($2.33 in chips) 
Seat 5: Lorpugo ($1.41 in chips) 
Seat 6: astca ($1.19 in chips) 
Lorpugo: posts small blind $0.01
astca: posts big blind $0.02
*** HOLE CARDS ***
Dealt to Lorpugo [6h 3c]
VillDimo: raises $0.04 to $0.06
Keremsen88: folds 
19dave72: folds 
Lorpugo: folds 
astca: calls $0.04
*** FLOP *** [7h 8h As]
astca: checks 
VillDimo: checks 
*** TURN *** [7h 8h As] [3h]
Malice247 joins the table at seat #3 
astca: checks 
VillDimo: checks 
*** RIVER *** [7h 8h As 3h] [Qc]
astca: checks 
VillDimo: checks 
*** SHOW DOWN ***
astca: shows [Td 8c] (a pair of Eights)
VillDimo: mucks hand 
astca collected $0.13 from pot
*** SUMMARY ***
Total pot $0.13 | Rake $0 
Board [7h 8h As 3h Qc]
Seat 1: VillDimo mucked [6s 6c]
Seat 2: Keremsen88 folded before Flop (didn't bet)
Seat 4: 19dave72 (button) folded before Flop (didn't bet)
Seat 5: Lorpugo (small blind) folded before Flop
Seat 6: astca (big blind) showed [Td 8c] and won ($0.13) with a pair of Eights



PokerStars Hand #240734134017:  Hold'em No Limit ($0.01/$0.02 USD) - 2022/12/27 15:33:46 ET
Table 'Ilsebill' 6-max Seat #5 is the button
Seat 1: VillDimo ($2 in chips) 
Seat 2: Keremsen88 ($2.24 in chips) 
Seat 4: 19dave72 ($2.33 in chips) 
Seat 5: Lorpugo ($1.40 in chips) 
Seat 6: astca ($1.26 in chips) 
astca: posts small blind $0.01
VillDimo: posts big blind $0.02
*** HOLE CARDS ***
Dealt to Lorpugo [2s Jd]
Keremsen88: folds 
19dave72: folds 
Lorpugo: folds 
astca: raises $0.04 to $0.06
VillDimo: calls $0.04
*** FLOP *** [7h Ts Js]
astca: checks 
VillDimo: bets $0.06
astca: calls $0.06
*** TURN *** [7h Ts Js] [3c]
astca: checks 
VillDimo: bets $0.16
astca: folds 
Uncalled bet ($0.16) returned to VillDimo
VillDimo collected $0.23 from pot
*** SUMMARY ***
Total pot $0.24 | Rake $0.01 
Board [7h Ts Js 3c]
Seat 1: VillDimo (big blind) collected ($0.23)
Seat 2: Keremsen88 folded before Flop (didn't bet)
Seat 4: 19dave72 folded before Flop (didn't bet)
Seat 5: Lorpugo (button) folded before Flop (didn't bet)
Seat 6: astca (small blind) folded on the Turn



PokerStars Hand #240734150691:  Hold'em No Limit ($0.01/$0.02 USD) - 2022/12/27 15:34:20 ET
Table 'Ilsebill' 6-max Seat #6 is the button
Seat 1: VillDimo ($2.11 in chips) 
Seat 2: Keremsen88 ($2.24 in chips) 
Seat 4: 19dave72 ($2.33 in chips) 
Seat 5: Lorpugo ($1.40 in chips) 
Seat 6: astca ($1.14 in chips) 
VillDimo: posts small blind $0.01
Keremsen88: posts big blind $0.02
*** HOLE CARDS ***
Dealt to Lorpugo [8h 7h]
19dave72: folds 
Lorpugo: raises $0.04 to $0.06
astca: folds 
VillDimo: folds 
Keremsen88: folds 
Uncalled bet ($0.04) returned to Lorpugo
Lorpugo collected $0.05 from pot
Lorpugo: doesn't show hand 
*** SUMMARY ***
Total pot $0.05 | Rake $0 
Seat 1: VillDimo (small blind) folded before Flop
Seat 2: Keremsen88 (big blind) folded before Flop
Seat 4: 19dave72 folded before Flop (didn't bet)
Seat 5: Lorpugo collected ($0.05)
Seat 6: astca (button) folded before Flop (didn't bet)



PokerStars Hand #240734156446:  Hold'em No Limit ($0.01/$0.02 USD) - 2022/12/27 15:34:32 ET
Table 'Ilsebill' 6-max Seat #1 is the button
Seat 1: VillDimo ($2.10 in chips) 
Seat 2: Keremsen88 ($2.22 in chips) 
Seat 3: Malice247 ($2 in chips) 
Seat 4: 19dave72 ($2.33 in chips) 
Seat 5: Lorpugo ($1.43 in chips) 
Seat 6: astca ($1.14 in chips) 
Keremsen88: posts small blind $0.01
Malice247: posts big blind $0.02
*** HOLE CARDS ***
Dealt to Lorpugo [8s 8d]
19dave72: folds 
Lorpugo: raises $0.04 to $0.06
astca: calls $0.06
VillDimo: folds 
Keremsen88: folds 
Malice247: folds 
*** FLOP *** [3d 7h 8h]
Lorpugo: bets $0.05
astca: raises $0.24 to $0.29
Lorpugo: raises $0.36 to $0.65
astca: calls $0.36
*** TURN *** [3d 7h 8h] [5c]
Lorpugo: bets $0.54
astca: calls $0.43 and is all-in
Uncalled bet ($0.11) returned to Lorpugo
*** RIVER *** [3d 7h 8h 5c] [4s]
*** SHOW DOWN ***
Lorpugo: shows [8s 8d] (three of a kind, Eights)
astca: shows [8c Tc] (a pair of Eights)
Lorpugo collected $2.23 from pot
*** SUMMARY ***
Total pot $2.31 | Rake $0.08 
Board [3d 7h 8h 5c 4s]
Seat 1: VillDimo (button) folded before Flop (didn't bet)
Seat 2: Keremsen88 (small blind) folded before Flop
Seat 3: Malice247 (big blind) folded before Flop
Seat 4: 19dave72 folded before Flop (didn't bet)
Seat 5: Lorpugo showed [8s 8d] and won ($2.23) with three of a kind, Eights
Seat 6: astca showed [8c Tc] and lost with a pair of Eights



PokerStars Hand #240734176488:  Hold'em No Limit ($0.01/$0.02 USD) - 2022/12/27 15:35:13 ET
Table 'Ilsebill' 6-max Seat #2 is the button
Seat 1: VillDimo ($2.10 in chips) 
Seat 2: Keremsen88 ($2.21 in chips) 
Seat 3: Malice247 ($1.98 in chips) 
Seat 4: 19dave72 ($2.33 in chips) 
Seat 5: Lorpugo ($2.52 in chips) 
Malice247: posts small blind $0.01
19dave72: posts big blind $0.02
*** HOLE CARDS ***
Dealt to Lorpugo [Td 2c]
Lorpugo: folds 
VillDimo: folds 
astca is disconnected 
Keremsen88: calls $0.02
Malice247: folds 
19dave72: checks 
*** FLOP *** [Kc 8s 6c]
19dave72: checks 
Keremsen88: checks 
*** TURN *** [Kc 8s 6c] [Tc]
19dave72: checks 
Keremsen88: checks 
*** RIVER *** [Kc 8s 6c Tc] [6s]
19dave72: bets $0.02
Keremsen88: calls $0.02
*** SHOW DOWN ***
19dave72: shows [5h Ks] (two pair, Kings and Sixes)
Keremsen88: shows [Ad 6d] (three of a kind, Sixes)
Keremsen88 collected $0.09 from pot
*** SUMMARY ***
Total pot $0.09 | Rake $0 
Board [Kc 8s 6c Tc 6s]
Seat 1: VillDimo folded before Flop (didn't bet)
Seat 2: Keremsen88 (button) showed [Ad 6d] and won ($0.09) with three of a kind, Sixes
Seat 3: Malice247 (small blind) folded before Flop
Seat 4: 19dave72 (big blind) showed [5h Ks] and lost with two pair, Kings and Sixes
Seat 5: Lorpugo folded before Flop (didn't bet)



PokerStars Hand #240734187445:  Hold'em No Limit ($0.01/$0.02 USD) - 2022/12/27 15:35:36 ET
Table 'Ilsebill' 6-max Seat #3 is the button
Seat 1: VillDimo ($2.10 in chips) 
Seat 2: Keremsen88 ($2.26 in chips) 
Seat 3: Malice247 ($1.97 in chips) 
Seat 4: 19dave72 ($2.29 in chips) 
Seat 5: Lorpugo ($2.52 in chips) 
19dave72: posts small blind $0.01
Lorpugo: posts big blind $0.02
*** HOLE CARDS ***
Dealt to Lorpugo [6h Qc]
VillDimo: folds 
Keremsen88: folds 
Malice247: folds 
19dave72: raises $0.04 to $0.06
Lorpugo: folds 
Uncalled bet ($0.04) returned to 19dave72
19dave72 collected $0.04 from pot
19dave72: doesn't show hand 
*** SUMMARY ***
Total pot $0.04 | Rake $0 
Seat 1: VillDimo folded before Flop (didn't bet)
Seat 2: Keremsen88 folded before Flop (didn't bet)
Seat 3: Malice247 (button) folded before Flop (didn't bet)
Seat 4: 19dave72 (small blind) collected ($0.04)
Seat 5: Lorpugo (big blind) folded before Flop



PokerStars Hand #240734192221:  Hold'em No Limit ($0.01/$0.02 USD) - 2022/12/27 15:35:46 ET
Table 'Ilsebill' 6-max Seat #4 is the button
Seat 1: VillDimo ($2.10 in chips) 
Seat 2: Keremsen88 ($2.26 in chips) 
Seat 3: Malice247 ($1.97 in chips) 
Seat 4: 19dave72 ($2.31 in chips) 
Seat 5: Lorpugo ($2.50 in chips) 
Lorpugo: posts small blind $0.01
VillDimo: posts big blind $0.02
*** HOLE CARDS ***
Dealt to Lorpugo [7s 2s]
Keremsen88: folds 
Malice247: folds 
19dave72: folds 
Lorpugo: folds 
Uncalled bet ($0.01) returned to VillDimo
VillDimo collected $0.02 from pot
*** SUMMARY ***
Total pot $0.02 | Rake $0 
Seat 1: VillDimo (big blind) collected ($0.02)
Seat 2: Keremsen88 folded before Flop (didn't bet)
Seat 3: Malice247 folded before Flop (didn't bet)
Seat 4: 19dave72 (button) folded before Flop (didn't bet)
Seat 5: Lorpugo (small blind) folded before Flop



PokerStars Hand #240734200523:  Hold'em No Limit ($0.01/$0.02 USD) - 2022/12/27 15:36:03 ET
Table 'Ilsebill' 6-max Seat #5 is the button
Seat 1: VillDimo ($2.11 in chips) 
Seat 2: Keremsen88 ($2.26 in chips) 
Seat 3: Malice247 ($1.97 in chips) 
Seat 4: 19dave72 ($2.31 in chips) 
Seat 5: Lorpugo ($2.49 in chips) 
VillDimo: posts small blind $0.01
Keremsen88: posts big blind $0.02
*** HOLE CARDS ***
Dealt to Lorpugo [As 2c]
Malice247: raises $0.02 to $0.04
19dave72: folds 
Lorpugo: folds 
VillDimo: folds 
Keremsen88: folds 
Uncalled bet ($0.02) returned to Malice247
Malice247 collected $0.05 from pot
*** SUMMARY ***
Total pot $0.05 | Rake $0 
Seat 1: VillDimo (small blind) folded before Flop
Seat 2: Keremsen88 (big blind) folded before Flop
Seat 3: Malice247 collected ($0.05)
Seat 4: 19dave72 folded before Flop (didn't bet)
Seat 5: Lorpugo (button) folded before Flop (didn't bet)



PokerStars Hand #240734204979:  Hold'em No Limit ($0.01/$0.02 USD) - 2022/12/27 15:36:12 ET
Table 'Ilsebill' 6-max Seat #1 is the button
Seat 1: VillDimo ($2.10 in chips) 
Seat 2: Keremsen88 ($2.24 in chips) 
Seat 3: Malice247 ($2 in chips) 
Seat 4: 19dave72 ($2.31 in chips) 
Seat 5: Lorpugo ($2.49 in chips) 
Keremsen88: posts small blind $0.01
Malice247: posts big blind $0.02
*** HOLE CARDS ***
Dealt to Lorpugo [3c 6c]
19dave72: folds 
Lorpugo: folds 
VillDimo: raises $0.04 to $0.06
Keremsen88: calls $0.05
Malice247: calls $0.04
*** FLOP *** [5c 4s Th]
Keremsen88: checks 
Malice247: checks 
VillDimo: bets $0.06
Keremsen88: folds 
Malice247: calls $0.06
*** TURN *** [5c 4s Th] [Kh]
Malice247: checks 
VillDimo: checks 
*** RIVER *** [5c 4s Th Kh] [Ac]
Malice247: checks 
VillDimo: checks 
*** SHOW DOWN ***
Malice247: shows [As 4d] (two pair, Aces and Fours)
VillDimo: mucks hand 
Malice247 collected $0.29 from pot
*** SUMMARY ***
Total pot $0.30 | Rake $0.01 
Board [5c 4s Th Kh Ac]
Seat 1: VillDimo (button) mucked [9s 9h]
Seat 2: Keremsen88 (small blind) folded on the Flop
Seat 3: Malice247 (big blind) showed [As 4d] and won ($0.29) with two pair, Aces and Fours
Seat 4: 19dave72 folded before Flop (didn't bet)
Seat 5: Lorpugo folded before Flop (didn't bet)



PokerStars Hand #240734248342:  Hold'em No Limit ($0.01/$0.02 USD) - 2022/12/27 15:37:42 ET
Table 'Ilsebill' 6-max Seat #2 is the button
Seat 1: VillDimo ($2 in chips) 
Seat 2: Keremsen88 ($2.18 in chips) 
Seat 4: 19dave72 ($2.31 in chips) 
Seat 5: Lorpugo ($2.49 in chips) 
19dave72: posts small blind $0.01
Lorpugo: posts big blind $0.02
*** HOLE CARDS ***
Dealt to Lorpugo [Kd 8c]
Malice247 leaves the table
VillDimo: folds 
Keremsen88: folds 
19dave72: folds 
Uncalled bet ($0.01) returned to Lorpugo
Lorpugo collected $0.02 from pot
Lorpugo: doesn't show hand 
*** SUMMARY ***
Total pot $0.02 | Rake $0 
Seat 1: VillDimo folded before Flop (didn't bet)
Seat 2: Keremsen88 (button) folded before Flop (didn't bet)
Seat 4: 19dave72 (small blind) folded before Flop
Seat 5: Lorpugo (big blind) collected ($0.02)



PokerStars Hand #240734251723:  Hold'em No Limit ($0.01/$0.02 USD) - 2022/12/27 15:37:49 ET
Table 'Ilsebill' 6-max Seat #4 is the button
Seat 1: VillDimo ($2 in chips) 
Seat 2: Keremsen88 ($2.18 in chips) 
Seat 4: 19dave72 ($2.30 in chips) 
Seat 5: Lorpugo ($2.50 in chips) 
Lorpugo: posts small blind $0.01
nekro211986 joins the table at seat #3 
VillDimo: posts big blind $0.02
*** HOLE CARDS ***
Dealt to Lorpugo [Js Ts]
Keremsen88: folds 
19dave72: folds 
Lorpugo: raises $0.04 to $0.06
VillDimo: folds 
Uncalled bet ($0.04) returned to Lorpugo
Lorpugo collected $0.04 from pot
Lorpugo: doesn't show hand 
*** SUMMARY ***
Total pot $0.04 | Rake $0 
Seat 1: VillDimo (big blind) folded before Flop
Seat 2: Keremsen88 folded before Flop (didn't bet)
Seat 4: 19dave72 (button) folded before Flop (didn't bet)
Seat 5: Lorpugo (small blind) collected ($0.04)



PokerStars Hand #240734256656:  Hold'em No Limit ($0.01/$0.02 USD) - 2022/12/27 15:37:59 ET
Table 'Ilsebill' 6-max Seat #5 is the button
Seat 1: VillDimo ($2 in chips) 
Seat 2: Keremsen88 ($2.18 in chips) 
Seat 4: 19dave72 ($2.30 in chips) 
Seat 5: Lorpugo ($2.52 in chips) 
VillDimo: posts small blind $0.01
Keremsen88: posts big blind $0.02
*** HOLE CARDS ***
Dealt to Lorpugo [Ad Jc]
19dave72: folds 
Lorpugo: raises $0.04 to $0.06
VillDimo: folds 
Keremsen88: calls $0.04
*** FLOP *** [5s Ah 8d]
Keremsen88: checks 
Lorpugo: bets $0.09
Keremsen88: folds 
Uncalled bet ($0.09) returned to Lorpugo
Lorpugo collected $0.13 from pot
Lorpugo: doesn't show hand 
*** SUMMARY ***
Total pot $0.13 | Rake $0 
Board [5s Ah 8d]
Seat 1: VillDimo (small blind) folded before Flop
Seat 2: Keremsen88 (big blind) folded on the Flop
Seat 4: 19dave72 folded before Flop (didn't bet)
Seat 5: Lorpugo (button) collected ($0.13)



PokerStars Hand #240734268123:  Hold'em No Limit ($0.01/$0.02 USD) - 2022/12/27 15:38:22 ET
Table 'Ilsebill' 6-max Seat #1 is the button
Seat 1: VillDimo ($2 in chips) 
Seat 2: Keremsen88 ($2.12 in chips) 
Seat 3: nekro211986 ($2 in chips) 
Seat 4: 19dave72 ($2.30 in chips) 
Seat 5: Lorpugo ($2.59 in chips) 
Keremsen88: posts small blind $0.01
nekro211986: posts big blind $0.02
*** HOLE CARDS ***
Dealt to Lorpugo [6s 7d]
19dave72: folds 
Lorpugo: folds 
VillDimo: folds 
Keremsen88: folds 
Uncalled bet ($0.01) returned to nekro211986
nekro211986 collected $0.02 from pot
nekro211986: doesn't show hand 
*** SUMMARY ***
Total pot $0.02 | Rake $0 
Seat 1: VillDimo (button) folded before Flop (didn't bet)
Seat 2: Keremsen88 (small blind) folded before Flop
Seat 3: nekro211986 (big blind) collected ($0.02)
Seat 4: 19dave72 folded before Flop (didn't bet)
Seat 5: Lorpugo folded before Flop (didn't bet)



PokerStars Hand #240734272431:  Hold'em No Limit ($0.01/$0.02 USD) - 2022/12/27 15:38:31 ET
Table 'Ilsebill' 6-max Seat #2 is the button
Seat 1: VillDimo ($2 in chips) 
Seat 2: Keremsen88 ($2.11 in chips) 
Seat 3: nekro211986 ($2.01 in chips) 
Seat 4: 19dave72 ($2.30 in chips) 
Seat 5: Lorpugo ($2.59 in chips) 
nekro211986: posts small blind $0.01
19dave72: posts big blind $0.02
*** HOLE CARDS ***
Dealt to Lorpugo [4h Ts]
Lorpugo: folds 
VillDimo: raises $0.04 to $0.06
Keremsen88: folds 
nekro211986: folds 
19dave72: folds 
Uncalled bet ($0.04) returned to VillDimo
VillDimo collected $0.05 from pot
*** SUMMARY ***
Total pot $0.05 | Rake $0 
Seat 1: VillDimo collected ($0.05)
Seat 2: Keremsen88 (button) folded before Flop (didn't bet)
Seat 3: nekro211986 (small blind) folded before Flop
Seat 4: 19dave72 (big blind) folded before Flop
Seat 5: Lorpugo folded before Flop (didn't bet)



PokerStars Hand #240734278498:  Hold'em No Limit ($0.01/$0.02 USD) - 2022/12/27 15:38:44 ET
Table 'Ilsebill' 6-max Seat #3 is the button
Seat 1: VillDimo ($2.03 in chips) 
Seat 2: Keremsen88 ($2.11 in chips) 
Seat 3: nekro211986 ($2 in chips) 
Seat 4: 19dave72 ($2.28 in chips) 
Seat 5: Lorpugo ($2.59 in chips) 
19dave72: posts small blind $0.01
Lorpugo: posts big blind $0.02
*** HOLE CARDS ***
Dealt to Lorpugo [8c 3d]
VillDimo: raises $0.04 to $0.06
Keremsen88: folds 
nekro211986: folds 
19dave72: folds 
Lorpugo: folds 
Uncalled bet ($0.04) returned to VillDimo
VillDimo collected $0.05 from pot
*** SUMMARY ***
Total pot $0.05 | Rake $0 
Seat 1: VillDimo collected ($0.05)
Seat 2: Keremsen88 folded before Flop (didn't bet)
Seat 3: nekro211986 (button) folded before Flop (didn't bet)
Seat 4: 19dave72 (small blind) folded before Flop
Seat 5: Lorpugo (big blind) folded before Flop



PokerStars Hand #240734284782:  Hold'em No Limit ($0.01/$0.02 USD) - 2022/12/27 15:38:57 ET
Table 'Ilsebill' 6-max Seat #4 is the button
Seat 1: VillDimo ($2.06 in chips) 
Seat 2: Keremsen88 ($2.11 in chips) 
Seat 3: nekro211986 ($2 in chips) 
Seat 4: 19dave72 ($2.27 in chips) 
Seat 5: Lorpugo ($2.57 in chips) 
Lorpugo: posts small blind $0.01
VillDimo: posts big blind $0.02
*** HOLE CARDS ***
Dealt to Lorpugo [Jc 9s]
Keremsen88 has timed out
Keremsen88: folds 
nekro211986: folds 
19dave72: raises $0.04 to $0.06
Lorpugo: folds 
VillDimo: folds 
Uncalled bet ($0.04) returned to 19dave72
19dave72 collected $0.05 from pot
19dave72: doesn't show hand 
*** SUMMARY ***
Total pot $0.05 | Rake $0 
Seat 1: VillDimo (big blind) folded before Flop
Seat 2: Keremsen88 folded before Flop (didn't bet)
Seat 3: nekro211986 folded before Flop (didn't bet)
Seat 4: 19dave72 (button) collected ($0.05)
Seat 5: Lorpugo (small blind) folded before Flop



PokerStars Hand #240734295125:  Hold'em No Limit ($0.01/$0.02 USD) - 2022/12/27 15:39:18 ET
Table 'Ilsebill' 6-max Seat #5 is the button
Seat 1: VillDimo ($2.04 in chips) 
Seat 2: Keremsen88 ($2.11 in chips) 
Seat 3: nekro211986 ($2 in chips) 
Seat 4: 19dave72 ($2.30 in chips) 
Seat 5: Lorpugo ($2.56 in chips) 
VillDimo: posts small blind $0.01
Keremsen88: posts big blind $0.02
*** HOLE CARDS ***
Dealt to Lorpugo [5h Jh]
nekro211986: folds 
19dave72: raises $0.04 to $0.06
Lorpugo: folds 
VillDimo: folds 
Keremsen88: calls $0.04
*** FLOP *** [2s 9s Ts]
Keremsen88: checks 
19dave72: bets $0.10
Keremsen88: folds 
Uncalled bet ($0.10) returned to 19dave72
19dave72 collected $0.13 from pot
19dave72: doesn't show hand 
*** SUMMARY ***
Total pot $0.13 | Rake $0 
Board [2s 9s Ts]
Seat 1: VillDimo (small blind) folded before Flop
Seat 2: Keremsen88 (big blind) folded on the Flop
Seat 3: nekro211986 folded before Flop (didn't bet)
Seat 4: 19dave72 collected ($0.13)
Seat 5: Lorpugo (button) folded before Flop (didn't bet)



PokerStars Hand #240734307935:  Hold'em No Limit ($0.01/$0.02 USD) - 2022/12/27 15:39:44 ET
Table 'Ilsebill' 6-max Seat #1 is the button
Seat 1: VillDimo ($2.03 in chips) 
Seat 2: Keremsen88 ($2.05 in chips) 
Seat 3: nekro211986 ($2 in chips) 
Seat 4: 19dave72 ($2.37 in chips) 
Seat 5: Lorpugo ($2.56 in chips) 
Keremsen88: posts small blind $0.01
nekro211986: posts big blind $0.02
*** HOLE CARDS ***
Dealt to Lorpugo [4h 9c]
19dave72: folds 
Lorpugo: folds 
VillDimo: raises $0.04 to $0.06
Keremsen88: folds 
nekro211986: folds 
Uncalled bet ($0.04) returned to VillDimo
VillDimo collected $0.05 from pot
*** SUMMARY ***
Total pot $0.05 | Rake $0 
Seat 1: VillDimo (button) collected ($0.05)
Seat 2: Keremsen88 (small blind) folded before Flop
Seat 3: nekro211986 (big blind) folded before Flop
Seat 4: 19dave72 folded before Flop (didn't bet)
Seat 5: Lorpugo folded before Flop (didn't bet)



PokerStars Hand #240734315941:  Hold'em No Limit ($0.01/$0.02 USD) - 2022/12/27 15:40:01 ET
Table 'Ilsebill' 6-max Seat #2 is the button
Seat 1: VillDimo ($2.06 in chips) 
Seat 2: Keremsen88 ($2.04 in chips) 
Seat 3: nekro211986 ($2 in chips) 
Seat 4: 19dave72 ($2.37 in chips) 
Seat 5: Lorpugo ($2.56 in chips) 
nekro211986: posts small blind $0.01
19dave72: posts big blind $0.02
*** HOLE CARDS ***
Dealt to Lorpugo [6d 2c]
Lorpugo: folds 
VillDimo: folds 
Keremsen88: calls $0.02
nekro211986: folds 
19dave72: checks 
*** FLOP *** [Qs Jd 2h]
astca leaves the table
19dave72: checks 
Keremsen88: checks 
*** TURN *** [Qs Jd 2h] [8s]
19dave72: bets $0.02
Keremsen88: folds 
Uncalled bet ($0.02) returned to 19dave72
19dave72 collected $0.05 from pot
19dave72: doesn't show hand 
*** SUMMARY ***
Total pot $0.05 | Rake $0 
Board [Qs Jd 2h 8s]
Seat 1: VillDimo folded before Flop (didn't bet)
Seat 2: Keremsen88 (button) folded on the Turn
Seat 3: nekro211986 (small blind) folded before Flop
Seat 4: 19dave72 (big blind) collected ($0.05)
Seat 5: Lorpugo folded before Flop (didn't bet)



PokerStars Hand #240734326169:  Hold'em No Limit ($0.01/$0.02 USD) - 2022/12/27 15:40:22 ET
Table 'Ilsebill' 6-max Seat #3 is the button
Seat 1: VillDimo ($2.06 in chips) 
Seat 2: Keremsen88 ($2.02 in chips) 
Seat 3: nekro211986 ($2 in chips) 
Seat 4: 19dave72 ($2.40 in chips) 
Seat 5: Lorpugo ($2.56 in chips) 
19dave72: posts small blind $0.01
Lorpugo: posts big blind $0.02
*** HOLE CARDS ***
Dealt to Lorpugo [4d Qh]
VillDimo: folds 
Keremsen88: folds 
nekro211986: folds 
tzughj joins the table at seat #6 
19dave72: raises $0.04 to $0.06
Lorpugo: folds 
Uncalled bet ($0.04) returned to 19dave72
19dave72 collected $0.04 from pot
19dave72: doesn't show hand 
*** SUMMARY ***
Total pot $0.04 | Rake $0 
Seat 1: VillDimo folded before Flop (didn't bet)
Seat 2: Keremsen88 folded before Flop (didn't bet)
Seat 3: nekro211986 (button) folded before Flop (didn't bet)
Seat 4: 19dave72 (small blind) collected ($0.04)
Seat 5: Lorpugo (big blind) folded before Flop



PokerStars Hand #240734334110:  Hold'em No Limit ($0.01/$0.02 USD) - 2022/12/27 15:40:39 ET
Table 'Ilsebill' 6-max Seat #4 is the button
Seat 1: VillDimo ($2.06 in chips) 
Seat 2: Keremsen88 ($2.02 in chips) 
Seat 3: nekro211986 ($2 in chips) 
Seat 4: 19dave72 ($2.42 in chips) 
Seat 5: Lorpugo ($2.54 in chips) 
Seat 6: tzughj ($1 in chips) 
Lorpugo: posts small blind $0.01
tzughj: posts big blind $0.02
*** HOLE CARDS ***
Dealt to Lorpugo [Qd 6s]
VillDimo: folds 
Keremsen88: folds 
nekro211986: folds 
19dave72: raises $0.04 to $0.06
Lorpugo: folds 
tzughj: folds 
Uncalled bet ($0.04) returned to 19dave72
19dave72 collected $0.05 from pot
19dave72: doesn't show hand 
*** SUMMARY ***
Total pot $0.05 | Rake $0 
Seat 1: VillDimo folded before Flop (didn't bet)
Seat 2: Keremsen88 folded before Flop (didn't bet)
Seat 3: nekro211986 folded before Flop (didn't bet)
Seat 4: 19dave72 (button) collected ($0.05)
Seat 5: Lorpugo (small blind) folded before Flop
Seat 6: tzughj (big blind) folded before Flop



PokerStars Hand #240734343946:  Hold'em No Limit ($0.01/$0.02 USD) - 2022/12/27 15:40:59 ET
Table 'Ilsebill' 6-max Seat #5 is the button
Seat 1: VillDimo ($2.06 in chips) 
Seat 2: Keremsen88 ($2.02 in chips) 
Seat 3: nekro211986 ($2 in chips) 
Seat 4: 19dave72 ($2.45 in chips) 
Seat 5: Lorpugo ($2.53 in chips) 
Seat 6: tzughj ($0.98 in chips) 
tzughj: posts small blind $0.01
VillDimo: posts big blind $0.02
*** HOLE CARDS ***
Dealt to Lorpugo [6d 4c]
Keremsen88: folds 
nekro211986: folds 
19dave72: raises $0.04 to $0.06
Lorpugo: folds 
tzughj: folds 
VillDimo: folds 
Uncalled bet ($0.04) returned to 19dave72
19dave72 collected $0.05 from pot
19dave72: doesn't show hand 
*** SUMMARY ***
Total pot $0.05 | Rake $0 
Seat 1: VillDimo (big blind) folded before Flop
Seat 2: Keremsen88 folded before Flop (didn't bet)
Seat 3: nekro211986 folded before Flop (didn't bet)
Seat 4: 19dave72 collected ($0.05)
Seat 5: Lorpugo (button) folded before Flop (didn't bet)
Seat 6: tzughj (small blind) folded before Flop



PokerStars Hand #240734353375:  Hold'em No Limit ($0.01/$0.02 USD) - 2022/12/27 15:41:19 ET
Table 'Ilsebill' 6-max Seat #6 is the button
Seat 1: VillDimo ($2.04 in chips) 
Seat 2: Keremsen88 ($2.02 in chips) 
Seat 3: nekro211986 ($2 in chips) 
Seat 4: 19dave72 ($2.48 in chips) 
Seat 5: Lorpugo ($2.53 in chips) 
Seat 6: tzughj ($0.97 in chips) 
VillDimo: posts small blind $0.01
Keremsen88: posts big blind $0.02
*** HOLE CARDS ***
Dealt to Lorpugo [6h 4s]
nekro211986: raises $0.04 to $0.06
19dave72: folds 
Lorpugo: folds 
tzughj: folds 
VillDimo: folds 
Keremsen88: calls $0.04
*** FLOP *** [6d 8d 3s]
Keremsen88: checks 
nekro211986: bets $0.06
Keremsen88: folds 
Uncalled bet ($0.06) returned to nekro211986
nekro211986 collected $0.13 from pot
nekro211986: doesn't show hand 
*** SUMMARY ***
Total pot $0.13 | Rake $0 
Board [6d 8d 3s]
Seat 1: VillDimo (small blind) folded before Flop
Seat 2: Keremsen88 (big blind) folded on the Flop
Seat 3: nekro211986 collected ($0.13)
Seat 4: 19dave72 folded before Flop (didn't bet)
Seat 5: Lorpugo folded before Flop (didn't bet)
Seat 6: tzughj (button) folded before Flop (didn't bet)



PokerStars Hand #240734367554:  Hold'em No Limit ($0.01/$0.02 USD) - 2022/12/27 15:41:48 ET
Table 'Ilsebill' 6-max Seat #1 is the button
Seat 1: VillDimo ($2.03 in chips) 
Seat 2: Keremsen88 ($1.96 in chips) 
Seat 3: nekro211986 ($2.07 in chips) 
Seat 4: 19dave72 ($2.48 in chips) 
Seat 5: Lorpugo ($2.53 in chips) 
Seat 6: tzughj ($0.97 in chips) 
Keremsen88: posts small blind $0.01
nekro211986: posts big blind $0.02
*** HOLE CARDS ***
Dealt to Lorpugo [9h Js]
19dave72: folds 
Lorpugo: folds 
tzughj: folds 
VillDimo: folds 
Keremsen88: folds 
Uncalled bet ($0.01) returned to nekro211986
nekro211986 collected $0.02 from pot
nekro211986: doesn't show hand 
*** SUMMARY ***
Total pot $0.02 | Rake $0 
Seat 1: VillDimo (button) folded before Flop (didn't bet)
Seat 2: Keremsen88 (small blind) folded before Flop
Seat 3: nekro211986 (big blind) collected ($0.02)
Seat 4: 19dave72 folded before Flop (didn't bet)
Seat 5: Lorpugo folded before Flop (didn't bet)
Seat 6: tzughj folded before Flop (didn't bet)



PokerStars Hand #240734371975:  Hold'em No Limit ($0.01/$0.02 USD) - 2022/12/27 15:41:57 ET
Table 'Ilsebill' 6-max Seat #2 is the button
Seat 1: VillDimo ($2.03 in chips) 
Seat 2: Keremsen88 ($1.95 in chips) 
Seat 3: nekro211986 ($2.08 in chips) 
Seat 4: 19dave72 ($2.48 in chips) 
Seat 5: Lorpugo ($2.53 in chips) 
Seat 6: tzughj ($0.97 in chips) 
nekro211986: posts small blind $0.01
19dave72: posts big blind $0.02
*** HOLE CARDS ***
Dealt to Lorpugo [2c 3s]
Lorpugo: folds 
tzughj: folds 
VillDimo: folds 
Keremsen88: folds 
nekro211986: raises $0.04 to $0.06
19dave72: folds 
Uncalled bet ($0.04) returned to nekro211986
nekro211986 collected $0.04 from pot
nekro211986: doesn't show hand 
*** SUMMARY ***
Total pot $0.04 | Rake $0 
Seat 1: VillDimo folded before Flop (didn't bet)
Seat 2: Keremsen88 (button) folded before Flop (didn't bet)
Seat 3: nekro211986 (small blind) collected ($0.04)
Seat 4: 19dave72 (big blind) folded before Flop
Seat 5: Lorpugo folded before Flop (didn't bet)
Seat 6: tzughj folded before Flop (didn't bet)



PokerStars Hand #240734380310:  Hold'em No Limit ($0.01/$0.02 USD) - 2022/12/27 15:42:15 ET
Table 'Ilsebill' 6-max Seat #3 is the button
Seat 1: VillDimo ($2.03 in chips) 
Seat 2: Keremsen88 ($1.95 in chips) 
Seat 3: nekro211986 ($2.10 in chips) 
Seat 4: 19dave72 ($2.46 in chips) 
Seat 5: Lorpugo ($2.53 in chips) 
Seat 6: tzughj ($0.97 in chips) 
19dave72: posts small blind $0.01
Lorpugo: posts big blind $0.02
*** HOLE CARDS ***
Dealt to Lorpugo [Jh 8s]
tzughj: calls $0.02
VillDimo: raises $0.06 to $0.08
Keremsen88: calls $0.08
nekro211986: folds 
19dave72: folds 
Lorpugo: folds 
tzughj: calls $0.06
*** FLOP *** [Jc Tc 6d]
tzughj: checks 
VillDimo: checks 
Keremsen88: checks 
*** TURN *** [Jc Tc 6d] [4c]
tzughj: checks 
VillDimo: bets $0.13
Keremsen88: folds 
tzughj: raises $0.13 to $0.26
VillDimo: calls $0.13
*** RIVER *** [Jc Tc 6d 4c] [Td]
tzughj: bets $0.38
VillDimo: folds 
Uncalled bet ($0.38) returned to tzughj
tzughj collected $0.75 from pot
tzughj: doesn't show hand 
*** SUMMARY ***
Total pot $0.79 | Rake $0.04 
Board [Jc Tc 6d 4c Td]
Seat 1: VillDimo folded on the River
Seat 2: Keremsen88 folded on the Turn
Seat 3: nekro211986 (button) folded before Flop (didn't bet)
Seat 4: 19dave72 (small blind) folded before Flop
Seat 5: Lorpugo (big blind) folded before Flop
Seat 6: tzughj collected ($0.75)



PokerStars Hand #240734407081:  Hold'em No Limit ($0.01/$0.02 USD) - 2022/12/27 15:43:10 ET
Table 'Ilsebill' 6-max Seat #4 is the button
Seat 1: VillDimo ($2 in chips) 
Seat 2: Keremsen88 ($1.87 in chips) 
Seat 3: nekro211986 ($2.10 in chips) 
Seat 4: 19dave72 ($2.45 in chips) 
Seat 5: Lorpugo ($2.51 in chips) 
Seat 6: tzughj ($1.38 in chips) 
Lorpugo: posts small blind $0.01
tzughj: posts big blind $0.02
*** HOLE CARDS ***
Dealt to Lorpugo [4h 9d]
VillDimo: folds 
Keremsen88: calls $0.02
nekro211986: folds 
19dave72: folds 
Lorpugo: folds 
tzughj: checks 
*** FLOP *** [2s 5h Td]
tzughj: checks 
Keremsen88: checks 
*** TURN *** [2s 5h Td] [9c]
tzughj: checks 
Keremsen88: bets $0.02
tzughj: folds 
Uncalled bet ($0.02) returned to Keremsen88
Keremsen88 collected $0.05 from pot
*** SUMMARY ***
Total pot $0.05 | Rake $0 
Board [2s 5h Td 9c]
Seat 1: VillDimo folded before Flop (didn't bet)
Seat 2: Keremsen88 collected ($0.05)
Seat 3: nekro211986 folded before Flop (didn't bet)
Seat 4: 19dave72 (button) folded before Flop (didn't bet)
Seat 5: Lorpugo (small blind) folded before Flop
Seat 6: tzughj (big blind) folded on the Turn



PokerStars Hand #240734421931:  Hold'em No Limit ($0.01/$0.02 USD) - 2022/12/27 15:43:41 ET
Table 'Ilsebill' 6-max Seat #5 is the button
Seat 1: VillDimo ($2 in chips) 
Seat 2: Keremsen88 ($1.90 in chips) 
Seat 3: nekro211986 ($2.10 in chips) 
Seat 4: 19dave72 ($2.45 in chips) 
Seat 5: Lorpugo ($2.50 in chips) 
Seat 6: tzughj ($1.36 in chips) 
tzughj: posts small blind $0.01
VillDimo: posts big blind $0.02
*** HOLE CARDS ***
Dealt to Lorpugo [4c 9s]
Keremsen88: folds 
nekro211986: folds 
19dave72: folds 
Lorpugo: folds 
tzughj: folds 
Uncalled bet ($0.01) returned to VillDimo
VillDimo collected $0.02 from pot
*** SUMMARY ***
Total pot $0.02 | Rake $0 
Seat 1: VillDimo (big blind) collected ($0.02)
Seat 2: Keremsen88 folded before Flop (didn't bet)
Seat 3: nekro211986 folded before Flop (didn't bet)
Seat 4: 19dave72 folded before Flop (didn't bet)
Seat 5: Lorpugo (button) folded before Flop (didn't bet)
Seat 6: tzughj (small blind) folded before Flop



PokerStars Hand #240734428408:  Hold'em No Limit ($0.01/$0.02 USD) - 2022/12/27 15:43:54 ET
Table 'Ilsebill' 6-max Seat #6 is the button
Seat 1: VillDimo ($2.01 in chips) 
Seat 2: Keremsen88 ($1.90 in chips) 
Seat 3: nekro211986 ($2.10 in chips) 
Seat 4: 19dave72 ($2.45 in chips) 
Seat 5: Lorpugo ($2.50 in chips) 
Seat 6: tzughj ($1.35 in chips) 
VillDimo: posts small blind $0.01
Keremsen88: posts big blind $0.02
*** HOLE CARDS ***
Dealt to Lorpugo [7c 6h]
nekro211986: raises $0.04 to $0.06
19dave72: folds 
Lorpugo: folds 
tzughj: calls $0.06
VillDimo: folds 
Keremsen88: folds 
*** FLOP *** [Ac 5s 9s]
nekro211986: bets $0.12
tzughj: calls $0.12
*** TURN *** [Ac 5s 9s] [2d]
nekro211986: bets $0.57
tzughj: folds 
Uncalled bet ($0.57) returned to nekro211986
nekro211986 collected $0.38 from pot
nekro211986: doesn't show hand 
*** SUMMARY ***
Total pot $0.39 | Rake $0.01 
Board [Ac 5s 9s 2d]
Seat 1: VillDimo (small blind) folded before Flop
Seat 2: Keremsen88 (big blind) folded before Flop
Seat 3: nekro211986 collected ($0.38)
Seat 4: 19dave72 folded before Flop (didn't bet)
Seat 5: Lorpugo folded before Flop (didn't bet)
Seat 6: tzughj (button) folded on the Turn



PokerStars Hand #240734444689:  Hold'em No Limit ($0.01/$0.02 USD) - 2022/12/27 15:44:28 ET
Table 'Ilsebill' 6-max Seat #1 is the button
Seat 1: VillDimo ($2 in chips) 
Seat 2: Keremsen88 ($1.88 in chips) 
Seat 3: nekro211986 ($2.30 in chips) 
Seat 4: 19dave72 ($2.45 in chips) 
Seat 5: Lorpugo ($2.50 in chips) 
Seat 6: tzughj ($1.17 in chips) 
Keremsen88: posts small blind $0.01
nekro211986: posts big blind $0.02
*** HOLE CARDS ***
Dealt to Lorpugo [7h Th]
19dave72: folds 
Lorpugo: folds 
tzughj: calls $0.02
VillDimo: folds 
Keremsen88: raises $0.04 to $0.06
nekro211986: folds 
tzughj: calls $0.04
*** FLOP *** [4c 5s Ad]
Keremsen88: checks 
tzughj: checks 
*** TURN *** [4c 5s Ad] [8s]
Keremsen88: bets $0.02
tzughj: calls $0.02
*** RIVER *** [4c 5s Ad 8s] [6h]
Keremsen88: checks 
tzughj: bets $0.17
Keremsen88: folds 
Uncalled bet ($0.17) returned to tzughj
tzughj collected $0.17 from pot
tzughj: doesn't show hand 
*** SUMMARY ***
Total pot $0.18 | Rake $0.01 
Board [4c 5s Ad 8s 6h]
Seat 1: VillDimo (button) folded before Flop (didn't bet)
Seat 2: Keremsen88 (small blind) folded on the River
Seat 3: nekro211986 (big blind) folded before Flop
Seat 4: 19dave72 folded before Flop (didn't bet)
Seat 5: Lorpugo folded before Flop (didn't bet)
Seat 6: tzughj collected ($0.17)



PokerStars Hand #240734465769:  Hold'em No Limit ($0.01/$0.02 USD) - 2022/12/27 15:45:12 ET
Table 'Ilsebill' 6-max Seat #2 is the button
Seat 1: VillDimo ($2 in chips) 
Seat 2: Keremsen88 ($1.80 in chips) 
Seat 3: nekro211986 ($2.28 in chips) 
Seat 4: 19dave72 ($2.45 in chips) 
Seat 5: Lorpugo ($2.50 in chips) 
Seat 6: tzughj ($1.26 in chips) 
nekro211986: posts small blind $0.01
19dave72: posts big blind $0.02
*** HOLE CARDS ***
Dealt to Lorpugo [2s 9h]
Lorpugo: folds 
tzughj: folds 
VillDimo: folds 
Keremsen88: raises $0.04 to $0.06
nekro211986: folds 
19dave72: folds 
Uncalled bet ($0.04) returned to Keremsen88
Keremsen88 collected $0.05 from pot
*** SUMMARY ***
Total pot $0.05 | Rake $0 
Seat 1: VillDimo folded before Flop (didn't bet)
Seat 2: Keremsen88 (button) collected ($0.05)
Seat 3: nekro211986 (small blind) folded before Flop
Seat 4: 19dave72 (big blind) folded before Flop
Seat 5: Lorpugo folded before Flop (didn't bet)
Seat 6: tzughj folded before Flop (didn't bet)



PokerStars Hand #240734473157:  Hold'em No Limit ($0.01/$0.02 USD) - 2022/12/27 15:45:27 ET
Table 'Ilsebill' 6-max Seat #3 is the button
Seat 1: VillDimo ($2 in chips) 
Seat 2: Keremsen88 ($1.83 in chips) 
Seat 3: nekro211986 ($2.27 in chips) 
Seat 4: 19dave72 ($2.43 in chips) 
Seat 5: Lorpugo ($2.50 in chips) 
Seat 6: tzughj ($1.26 in chips) 
19dave72: posts small blind $0.01
Lorpugo: posts big blind $0.02
*** HOLE CARDS ***
Dealt to Lorpugo [4h 3s]
tzughj: folds 
VillDimo: folds 
Keremsen88: folds 
nekro211986: folds 
19dave72: folds 
Uncalled bet ($0.01) returned to Lorpugo
Lorpugo collected $0.02 from pot
Lorpugo: doesn't show hand 
*** SUMMARY ***
Total pot $0.02 | Rake $0 
Seat 1: VillDimo folded before Flop (didn't bet)
Seat 2: Keremsen88 folded before Flop (didn't bet)
Seat 3: nekro211986 (button) folded before Flop (didn't bet)
Seat 4: 19dave72 (small blind) folded before Flop
Seat 5: Lorpugo (big blind) collected ($0.02)
Seat 6: tzughj folded before Flop (didn't bet)



PokerStars Hand #240734478291:  Hold'em No Limit ($0.01/$0.02 USD) - 2022/12/27 15:45:38 ET
Table 'Ilsebill' 6-max Seat #4 is the button
Seat 1: VillDimo ($2 in chips) 
Seat 2: Keremsen88 ($1.83 in chips) 
Seat 3: nekro211986 ($2.27 in chips) 
Seat 4: 19dave72 ($2.42 in chips) 
Seat 5: Lorpugo ($2.51 in chips) 
Seat 6: tzughj ($1.26 in chips) 
Lorpugo: posts small blind $0.01
tzughj: posts big blind $0.02
*** HOLE CARDS ***
Dealt to Lorpugo [3h Td]
VillDimo: folds 
Keremsen88: folds 
nekro211986: folds 
19dave72: folds 
Lorpugo: folds 
Uncalled bet ($0.01) returned to tzughj
tzughj collected $0.02 from pot
tzughj: doesn't show hand 
*** SUMMARY ***
Total pot $0.02 | Rake $0 
Seat 1: VillDimo folded before Flop (didn't bet)
Seat 2: Keremsen88 folded before Flop (didn't bet)
Seat 3: nekro211986 folded before Flop (didn't bet)
Seat 4: 19dave72 (button) folded before Flop (didn't bet)
Seat 5: Lorpugo (small blind) folded before Flop
Seat 6: tzughj (big blind) collected ($0.02)



PokerStars Hand #240734484936:  Hold'em No Limit ($0.01/$0.02 USD) - 2022/12/27 15:45:51 ET
Table 'Ilsebill' 6-max Seat #5 is the button
Seat 1: VillDimo ($2 in chips) 
Seat 2: Keremsen88 ($1.83 in chips) 
Seat 3: nekro211986 ($2.27 in chips) 
Seat 4: 19dave72 ($2.42 in chips) 
Seat 5: Lorpugo ($2.50 in chips) 
Seat 6: tzughj ($1.27 in chips) 
tzughj: posts small blind $0.01
VillDimo: posts big blind $0.02
*** HOLE CARDS ***
Dealt to Lorpugo [2s 5c]
Keremsen88: folds 
nekro211986: folds 
19dave72: raises $0.04 to $0.06
Lorpugo: folds 
tzughj: folds 
VillDimo: folds 
Uncalled bet ($0.04) returned to 19dave72
19dave72 collected $0.05 from pot
19dave72: doesn't show hand 
*** SUMMARY ***
Total pot $0.05 | Rake $0 
Seat 1: VillDimo (big blind) folded before Flop
Seat 2: Keremsen88 folded before Flop (didn't bet)
Seat 3: nekro211986 folded before Flop (didn't bet)
Seat 4: 19dave72 collected ($0.05)
Seat 5: Lorpugo (button) folded before Flop (didn't bet)
Seat 6: tzughj (small blind) folded before Flop



PokerStars Hand #240734492214:  Hold'em No Limit ($0.01/$0.02 USD) - 2022/12/27 15:46:07 ET
Table 'Ilsebill' 6-max Seat #6 is the button
Seat 1: VillDimo ($2 in chips) 
Seat 2: Keremsen88 ($1.83 in chips) 
Seat 3: nekro211986 ($2.27 in chips) 
Seat 4: 19dave72 ($2.45 in chips) 
Seat 5: Lorpugo ($2.50 in chips) 
Seat 6: tzughj ($1.26 in chips) 
VillDimo: posts small blind $0.01
Keremsen88: posts big blind $0.02
*** HOLE CARDS ***
Dealt to Lorpugo [8c Tc]
nekro211986: raises $0.04 to $0.06
19dave72: folds 
Lorpugo: folds 
tzughj: folds 
VillDimo: folds 
Keremsen88: calls $0.04
*** FLOP *** [Qs 3s 8s]
Keremsen88: bets $0.02
nekro211986: calls $0.02
*** TURN *** [Qs 3s 8s] [3h]
Keremsen88: checks 
nekro211986: bets $0.08
Keremsen88: folds 
Uncalled bet ($0.08) returned to nekro211986
nekro211986 collected $0.16 from pot
nekro211986: doesn't show hand 
*** SUMMARY ***
Total pot $0.17 | Rake $0.01 
Board [Qs 3s 8s 3h]
Seat 1: VillDimo (small blind) folded before Flop
Seat 2: Keremsen88 (big blind) folded on the Turn
Seat 3: nekro211986 collected ($0.16)
Seat 4: 19dave72 folded before Flop (didn't bet)
Seat 5: Lorpugo folded before Flop (didn't bet)
Seat 6: tzughj (button) folded before Flop (didn't bet)



PokerStars Hand #240734510560:  Hold'em No Limit ($0.01/$0.02 USD) - 2022/12/27 15:46:45 ET
Table 'Ilsebill' 6-max Seat #1 is the button
Seat 1: VillDimo ($2 in chips) 
Seat 2: Keremsen88 ($1.75 in chips) 
Seat 3: nekro211986 ($2.35 in chips) 
Seat 4: 19dave72 ($2.45 in chips) 
Seat 5: Lorpugo ($2.50 in chips) 
Seat 6: tzughj ($1.26 in chips) 
Keremsen88: posts small blind $0.01
nekro211986: posts big blind $0.02
*** HOLE CARDS ***
Dealt to Lorpugo [9c 4d]
19dave72: folds 
Lorpugo: folds 
tzughj: calls $0.02
VillDimo: calls $0.02
Keremsen88: calls $0.01
nekro211986: checks 
*** FLOP *** [9d As 6d]
Keremsen88: checks 
nekro211986: checks 
tzughj: checks 
VillDimo: checks 
*** TURN *** [9d As 6d] [Ks]
Keremsen88: checks 
nekro211986: checks 
tzughj: bets $0.04
VillDimo: folds 
Keremsen88: folds 
nekro211986: folds 
Uncalled bet ($0.04) returned to tzughj
tzughj collected $0.08 from pot
tzughj: doesn't show hand 
*** SUMMARY ***
Total pot $0.08 | Rake $0 
Board [9d As 6d Ks]
Seat 1: VillDimo (button) folded on the Turn
Seat 2: Keremsen88 (small blind) folded on the Turn
Seat 3: nekro211986 (big blind) folded on the Turn
Seat 4: 19dave72 folded before Flop (didn't bet)
Seat 5: Lorpugo folded before Flop (didn't bet)
Seat 6: tzughj collected ($0.08)



PokerStars Hand #240734538332:  Hold'em No Limit ($0.01/$0.02 USD) - 2022/12/27 15:47:43 ET
Table 'Ilsebill' 6-max Seat #2 is the button
Seat 1: VillDimo ($2 in chips) 
Seat 2: Keremsen88 ($1.73 in chips) 
Seat 3: nekro211986 ($2.33 in chips) 
Seat 4: 19dave72 ($2.45 in chips) 
Seat 5: Lorpugo ($2.50 in chips) 
Seat 6: tzughj ($1.32 in chips) 
nekro211986: posts small blind $0.01
19dave72: posts big blind $0.02
*** HOLE CARDS ***
Dealt to Lorpugo [3s 5s]
Lorpugo: folds 
tzughj: folds 
VillDimo: folds 
Keremsen88: folds 
nekro211986: folds 
Uncalled bet ($0.01) returned to 19dave72
19dave72 collected $0.02 from pot
19dave72: doesn't show hand 
*** SUMMARY ***
Total pot $0.02 | Rake $0 
Seat 1: VillDimo folded before Flop (didn't bet)
Seat 2: Keremsen88 (button) folded before Flop (didn't bet)
Seat 3: nekro211986 (small blind) folded before Flop
Seat 4: 19dave72 (big blind) collected ($0.02)
Seat 5: Lorpugo folded before Flop (didn't bet)
Seat 6: tzughj folded before Flop (didn't bet)



PokerStars Hand #240734543310:  Hold'em No Limit ($0.01/$0.02 USD) - 2022/12/27 15:47:54 ET
Table 'Ilsebill' 6-max Seat #3 is the button
Seat 1: VillDimo ($2 in chips) 
Seat 2: Keremsen88 ($1.73 in chips) 
Seat 3: nekro211986 ($2.32 in chips) 
Seat 4: 19dave72 ($2.46 in chips) 
Seat 5: Lorpugo ($2.50 in chips) 
Seat 6: tzughj ($1.32 in chips) 
19dave72: posts small blind $0.01
Lorpugo: posts big blind $0.02
*** HOLE CARDS ***
Dealt to Lorpugo [8h 2s]
tzughj: folds 
VillDimo: folds 
Keremsen88: raises $0.04 to $0.06
nekro211986: raises $0.10 to $0.16
19dave72: folds 
Lorpugo: folds 
Keremsen88: calls $0.10
*** FLOP *** [As Js 7s]
Keremsen88: checks 
tzughj leaves the table
nekro211986: bets $0.22
Cortez118 joins the table at seat #6 
Keremsen88: folds 
Uncalled bet ($0.22) returned to nekro211986
nekro211986 collected $0.34 from pot
nekro211986: doesn't show hand 
*** SUMMARY ***
Total pot $0.35 | Rake $0.01 
Board [As Js 7s]
Seat 1: VillDimo folded before Flop (didn't bet)
Seat 2: Keremsen88 folded on the Flop
Seat 3: nekro211986 (button) collected ($0.34)
Seat 4: 19dave72 (small blind) folded before Flop
Seat 5: Lorpugo (big blind) folded before Flop
Seat 6: tzughj folded before Flop (didn't bet)



PokerStars Hand #240734567160:  Hold'em No Limit ($0.01/$0.02 USD) - 2022/12/27 15:48:44 ET
Table 'Ilsebill' 6-max Seat #4 is the button
Seat 1: VillDimo ($2 in chips) 
Seat 2: Keremsen88 ($1.57 in chips) 
Seat 3: nekro211986 ($2.50 in chips) 
Seat 4: 19dave72 ($2.45 in chips) 
Seat 5: Lorpugo ($2.48 in chips) 
Seat 6: Cortez118 ($1.24 in chips) 
Lorpugo: posts small blind $0.01
Cortez118: posts big blind $0.02
*** HOLE CARDS ***
Dealt to Lorpugo [2d Tc]
VillDimo: raises $0.04 to $0.06
Keremsen88: folds 
nekro211986: folds 
19dave72: folds 
Lorpugo: folds 
Cortez118: calls $0.04
*** FLOP *** [Td 9c 8d]
Cortez118: bets $0.10
VillDimo: raises $0.26 to $0.36
Cortez118: raises $0.26 to $0.62
VillDimo: raises $1.32 to $1.94 and is all-in
Cortez118: calls $0.56 and is all-in
Uncalled bet ($0.76) returned to VillDimo
*** TURN *** [Td 9c 8d] [As]
*** RIVER *** [Td 9c 8d As] [6s]
*** SHOW DOWN ***
Cortez118: shows [9s Kc] (a pair of Nines)
VillDimo: shows [Jc Qs] (a straight, Eight to Queen)
VillDimo collected $2.40 from pot
*** SUMMARY ***
Total pot $2.49 | Rake $0.09 
Board [Td 9c 8d As 6s]
Seat 1: VillDimo showed [Jc Qs] and won ($2.40) with a straight, Eight to Queen
Seat 2: Keremsen88 folded before Flop (didn't bet)
Seat 3: nekro211986 folded before Flop (didn't bet)
Seat 4: 19dave72 (button) folded before Flop (didn't bet)
Seat 5: Lorpugo (small blind) folded before Flop
Seat 6: Cortez118 (big blind) showed [9s Kc] and lost with a pair of Nines



PokerStars Hand #240734591045:  Hold'em No Limit ($0.01/$0.02 USD) - 2022/12/27 15:49:34 ET
Table 'Ilsebill' 6-max Seat #5 is the button
Seat 1: VillDimo ($3.16 in chips) 
Seat 2: Keremsen88 ($1.57 in chips) 
Seat 3: nekro211986 ($2.50 in chips) 
Seat 4: 19dave72 ($2.45 in chips) 
Seat 5: Lorpugo ($2.47 in chips) 
VillDimo: posts small blind $0.01
Keremsen88: posts big blind $0.02
*** HOLE CARDS ***
Dealt to Lorpugo [5c Qc]
nekro211986: folds 
19dave72: folds 
Lorpugo: raises $0.04 to $0.06
VillDimo: folds 
Keremsen88: calls $0.04
*** FLOP *** [Th 9s Kc]
Keremsen88: checks 
Lorpugo: checks 
*** TURN *** [Th 9s Kc] [6s]
Keremsen88: checks 
Lorpugo: checks 
*** RIVER *** [Th 9s Kc 6s] [3c]
Keremsen88: checks 
Lorpugo: checks 
*** SHOW DOWN ***
Keremsen88: shows [Jc 9c] (a pair of Nines)
Lorpugo: mucks hand 
Keremsen88 collected $0.13 from pot
*** SUMMARY ***
Total pot $0.13 | Rake $0 
Board [Th 9s Kc 6s 3c]
Seat 1: VillDimo (small blind) folded before Flop
Seat 2: Keremsen88 (big blind) showed [Jc 9c] and won ($0.13) with a pair of Nines
Seat 3: nekro211986 folded before Flop (didn't bet)
Seat 4: 19dave72 folded before Flop (didn't bet)
Seat 5: Lorpugo (button) mucked [5c Qc]



PokerStars Hand #240734606148:  Hold'em No Limit ($0.01/$0.02 USD) - 2022/12/27 15:50:05 ET
Table 'Ilsebill' 6-max Seat #1 is the button
Seat 1: VillDimo ($3.15 in chips) 
Seat 2: Keremsen88 ($1.64 in chips) 
Seat 3: nekro211986 ($2.50 in chips) 
Seat 4: 19dave72 ($2.45 in chips) 
Seat 5: Lorpugo ($2.41 in chips) 
Keremsen88: posts small blind $0.01
nekro211986: posts big blind $0.02
*** HOLE CARDS ***
Dealt to Lorpugo [3h 4c]
19dave72: folds 
Lorpugo: folds 
VillDimo: folds 
Keremsen88: folds 
Uncalled bet ($0.01) returned to nekro211986
nekro211986 collected $0.02 from pot
nekro211986: doesn't show hand 
*** SUMMARY ***
Total pot $0.02 | Rake $0 
Seat 1: VillDimo (button) folded before Flop (didn't bet)
Seat 2: Keremsen88 (small blind) folded before Flop
Seat 3: nekro211986 (big blind) collected ($0.02)
Seat 4: 19dave72 folded before Flop (didn't bet)
Seat 5: Lorpugo folded before Flop (didn't bet)



PokerStars Hand #240734613154:  Hold'em No Limit ($0.01/$0.02 USD) - 2022/12/27 15:50:20 ET
Table 'Ilsebill' 6-max Seat #2 is the button
Seat 1: VillDimo ($3.15 in chips) 
Seat 2: Keremsen88 ($1.63 in chips) 
Seat 3: nekro211986 ($2.51 in chips) 
Seat 4: 19dave72 ($2.45 in chips) 
Seat 5: Lorpugo ($2.41 in chips) 
nekro211986: posts small blind $0.01
19dave72: posts big blind $0.02
*** HOLE CARDS ***
Dealt to Lorpugo [5h 7s]
Lorpugo: folds 
VillDimo: folds 
Keremsen88: folds 
nekro211986: folds 
Uncalled bet ($0.01) returned to 19dave72
19dave72 collected $0.02 from pot
19dave72: doesn't show hand 
*** SUMMARY ***
Total pot $0.02 | Rake $0 
Seat 1: VillDimo folded before Flop (didn't bet)
Seat 2: Keremsen88 (button) folded before Flop (didn't bet)
Seat 3: nekro211986 (small blind) folded before Flop
Seat 4: 19dave72 (big blind) collected ($0.02)
Seat 5: Lorpugo folded before Flop (didn't bet)



PokerStars Hand #240734623453:  Hold'em No Limit ($0.01/$0.02 USD) - 2022/12/27 15:50:41 ET
Table 'Ilsebill' 6-max Seat #3 is the button
Seat 1: VillDimo ($3.15 in chips) 
Seat 2: Keremsen88 ($1.63 in chips) 
Seat 3: nekro211986 ($2.50 in chips) 
Seat 4: 19dave72 ($2.46 in chips) 
Seat 5: Lorpugo ($2.41 in chips) 
19dave72: posts small blind $0.01
Lorpugo: posts big blind $0.02
*** HOLE CARDS ***
Dealt to Lorpugo [Jc 2s]
VillDimo: folds 
Keremsen88: raises $0.04 to $0.06
nekro211986: folds 
19dave72: folds 
Lorpugo: folds 
Uncalled bet ($0.04) returned to Keremsen88
Keremsen88 collected $0.05 from pot
*** SUMMARY ***
Total pot $0.05 | Rake $0 
Seat 1: VillDimo folded before Flop (didn't bet)
Seat 2: Keremsen88 collected ($0.05)
Seat 3: nekro211986 (button) folded before Flop (didn't bet)
Seat 4: 19dave72 (small blind) folded before Flop
Seat 5: Lorpugo (big blind) folded before Flop



PokerStars Hand #240734630177:  Hold'em No Limit ($0.01/$0.02 USD) - 2022/12/27 15:50:56 ET
Table 'Ilsebill' 6-max Seat #4 is the button
Seat 2: Keremsen88 ($1.66 in chips) 
Seat 3: nekro211986 ($2.50 in chips) 
Seat 4: 19dave72 ($2.45 in chips) 
Seat 5: Lorpugo ($2.39 in chips) 
Lorpugo: posts small blind $0.01
Keremsen88: posts big blind $0.02
*** HOLE CARDS ***
Dealt to Lorpugo [4s 8d]
nekro211986: folds 
VillDimo leaves the table
19dave72: folds 
Lorpugo: folds 
Uncalled bet ($0.01) returned to Keremsen88
Keremsen88 collected $0.02 from pot
*** SUMMARY ***
Total pot $0.02 | Rake $0 
Seat 2: Keremsen88 (big blind) collected ($0.02)
Seat 3: nekro211986 folded before Flop (didn't bet)
Seat 4: 19dave72 (button) folded before Flop (didn't bet)
Seat 5: Lorpugo (small blind) folded before Flop



PokerStars Hand #240734639079:  Hold'em No Limit ($0.01/$0.02 USD) - 2022/12/27 15:51:14 ET
Table 'Ilsebill' 6-max Seat #5 is the button
Seat 2: Keremsen88 ($1.67 in chips) 
Seat 3: nekro211986 ($2.50 in chips) 
Seat 4: 19dave72 ($2.45 in chips) 
Seat 5: Lorpugo ($2.38 in chips) 
Keremsen88: posts small blind $0.01
Buhbbj joins the table at seat #1 
nekro211986: posts big blind $0.02
*** HOLE CARDS ***
Dealt to Lorpugo [7c Kd]
19dave72: folds 
Lorpugo: raises $0.04 to $0.06
Keremsen88: folds 
nekro211986: folds 
Uncalled bet ($0.04) returned to Lorpugo
Lorpugo collected $0.05 from pot
Lorpugo: doesn't show hand 
*** SUMMARY ***
Total pot $0.05 | Rake $0 
Seat 2: Keremsen88 (small blind) folded before Flop
Seat 3: nekro211986 (big blind) folded before Flop
Seat 4: 19dave72 folded before Flop (didn't bet)
Seat 5: Lorpugo (button) collected ($0.05)



PokerStars Hand #240734646301:  Hold'em No Limit ($0.01/$0.02 USD) - 2022/12/27 15:51:29 ET
Table 'Ilsebill' 6-max Seat #2 is the button
Seat 2: Keremsen88 ($1.66 in chips) 
Seat 3: nekro211986 ($2.48 in chips) 
Seat 5: Lorpugo ($2.41 in chips) 
nekro211986: posts small blind $0.01
Lorpugo: posts big blind $0.02
*** HOLE CARDS ***
Dealt to Lorpugo [3d 9c]
19dave72 leaves the table
CV Don Chris joins the table at seat #4 
Keremsen88: raises $0.04 to $0.06
nekro211986: calls $0.05
Lorpugo: folds 
*** FLOP *** [7h Ts 8s]
nekro211986: checks 
Keremsen88: checks 
*** TURN *** [7h Ts 8s] [Kc]
nekro211986: checks 
Keremsen88: checks 
*** RIVER *** [7h Ts 8s Kc] [2c]
nekro211986: checks 
Keremsen88: checks 
*** SHOW DOWN ***
nekro211986: shows [8h 9h] (a pair of Eights)
Keremsen88: mucks hand 
nekro211986 collected $0.14 from pot
*** SUMMARY ***
Total pot $0.14 | Rake $0 
Board [7h Ts 8s Kc 2c]
Seat 2: Keremsen88 (button) mucked [6h 6d]
Seat 3: nekro211986 (small blind) showed [8h 9h] and won ($0.14) with a pair of Eights
Seat 5: Lorpugo (big blind) folded before Flop



PokerStars Hand #240734664350:  Hold'em No Limit ($0.01/$0.02 USD) - 2022/12/27 15:52:07 ET
Table 'Ilsebill' 6-max Seat #3 is the button
Seat 1: Buhbbj ($1 in chips) 
Seat 2: Keremsen88 ($1.60 in chips) 
Seat 3: nekro211986 ($2.56 in chips) 
Seat 5: Lorpugo ($2.39 in chips) 
Lorpugo: posts small blind $0.01
Buhbbj: posts big blind $0.02
*** HOLE CARDS ***
Dealt to Lorpugo [Ac 7s]
Keremsen88: calls $0.02
nekro211986: folds 
Lorpugo: calls $0.01
Buhbbj: checks 
*** FLOP *** [Jc Td 2h]
Lorpugo: checks 
Buhbbj: checks 
Keremsen88: bets $0.06
Lorpugo: folds 
Buhbbj: calls $0.06
*** TURN *** [Jc Td 2h] [Jd]
Buhbbj: bets $0.04
Keremsen88: folds 
Uncalled bet ($0.04) returned to Buhbbj
Buhbbj collected $0.17 from pot
*** SUMMARY ***
Total pot $0.18 | Rake $0.01 
Board [Jc Td 2h Jd]
Seat 1: Buhbbj (big blind) collected ($0.17)
Seat 2: Keremsen88 folded on the Turn
Seat 3: nekro211986 (button) folded before Flop (didn't bet)
Seat 5: Lorpugo (small blind) folded on the Flop



PokerStars Hand #240734687380:  Hold'em No Limit ($0.01/$0.02 USD) - 2022/12/27 15:52:55 ET
Table 'Ilsebill' 6-max Seat #5 is the button
Seat 1: Buhbbj ($1.09 in chips) 
Seat 2: Keremsen88 ($1.52 in chips) 
Seat 3: nekro211986 ($2.56 in chips) 
Seat 4: CV Don Chris ($2 in chips) 
Seat 5: Lorpugo ($2.37 in chips) 
Buhbbj: posts small blind $0.01
Keremsen88: posts big blind $0.02
CV Don Chris: posts big blind $0.02
*** HOLE CARDS ***
Dealt to Lorpugo [4c Th]
nekro211986: folds 
CV Don Chris: checks 
Lorpugo: folds 
Buhbbj: folds 
Keremsen88: checks 
*** FLOP *** [7s 4d Qd]
Keremsen88: checks 
CV Don Chris: bets $0.05
Keremsen88: folds 
Uncalled bet ($0.05) returned to CV Don Chris
CV Don Chris collected $0.05 from pot
*** SUMMARY ***
Total pot $0.05 | Rake $0 
Board [7s 4d Qd]
Seat 1: Buhbbj (small blind) folded before Flop
Seat 2: Keremsen88 (big blind) folded on the Flop
Seat 3: nekro211986 folded before Flop (didn't bet)
Seat 4: CV Don Chris collected ($0.05)
Seat 5: Lorpugo (button) folded before Flop (didn't bet)



PokerStars Hand #240734704449:  Hold'em No Limit ($0.01/$0.02 USD) - 2022/12/27 15:53:31 ET
Table 'Ilsebill' 6-max Seat #1 is the button
Seat 1: Buhbbj ($1.08 in chips) 
Seat 2: Keremsen88 ($1.50 in chips) 
Seat 3: nekro211986 ($2.56 in chips) 
Seat 4: CV Don Chris ($2.03 in chips) 
Seat 5: Lorpugo ($2.37 in chips) 
Keremsen88: posts small blind $0.01
nekro211986: posts big blind $0.02
*** HOLE CARDS ***
Dealt to Lorpugo [3c Ac]
CV Don Chris: raises $0.04 to $0.06
Lorpugo: folds 
Buhbbj: folds 
Keremsen88: calls $0.05
nekro211986: folds 
*** FLOP *** [Jc Ks 2c]
Keremsen88: bets $0.07
CV Don Chris: raises $0.15 to $0.22
Keremsen88: folds 
Uncalled bet ($0.15) returned to CV Don Chris
CV Don Chris collected $0.27 from pot
*** SUMMARY ***
Total pot $0.28 | Rake $0.01 
Board [Jc Ks 2c]
Seat 1: Buhbbj (button) folded before Flop (didn't bet)
Seat 2: Keremsen88 (small blind) folded on the Flop
Seat 3: nekro211986 (big blind) folded before Flop
Seat 4: CV Don Chris collected ($0.27)
Seat 5: Lorpugo folded before Flop (didn't bet)



PokerStars Hand #240734731050:  Hold'em No Limit ($0.01/$0.02 USD) - 2022/12/27 15:54:26 ET
Table 'Ilsebill' 6-max Seat #2 is the button
Seat 1: Buhbbj ($1.08 in chips) 
Seat 2: Keremsen88 ($1.37 in chips) 
Seat 3: nekro211986 ($2.54 in chips) 
Seat 4: CV Don Chris ($2.17 in chips) 
Seat 5: Lorpugo ($2.37 in chips) 
nekro211986: posts small blind $0.01
CV Don Chris: posts big blind $0.02
*** HOLE CARDS ***
Dealt to Lorpugo [8h Tc]
Lorpugo: folds 
Buhbbj: calls $0.02
Keremsen88: calls $0.02
nekro211986: raises $0.08 to $0.10
CV Don Chris: folds 
Buhbbj: folds 
Keremsen88: calls $0.08
*** FLOP *** [6h 7h 7s]
nekro211986: bets $0.08
Keremsen88: folds 
Uncalled bet ($0.08) returned to nekro211986
nekro211986 collected $0.23 from pot
nekro211986: doesn't show hand 
*** SUMMARY ***
Total pot $0.24 | Rake $0.01 
Board [6h 7h 7s]
Seat 1: Buhbbj folded before Flop
Seat 2: Keremsen88 (button) folded on the Flop
Seat 3: nekro211986 (small blind) collected ($0.23)
Seat 4: CV Don Chris (big blind) folded before Flop
Seat 5: Lorpugo folded before Flop (didn't bet)



PokerStars Hand #240734752319:  Hold'em No Limit ($0.01/$0.02 USD) - 2022/12/27 15:55:13 ET
Table 'Ilsebill' 6-max Seat #3 is the button
Seat 1: Buhbbj ($1.06 in chips) 
Seat 2: Keremsen88 ($1.27 in chips) 
Seat 3: nekro211986 ($2.67 in chips) 
Seat 4: CV Don Chris ($2.15 in chips) 
Seat 5: Lorpugo ($2.37 in chips) 
CV Don Chris: posts small blind $0.01
Lorpugo: posts big blind $0.02
*** HOLE CARDS ***
Dealt to Lorpugo [Ts 8c]
Buhbbj: folds 
Keremsen88: raises $0.04 to $0.06
nekro211986: folds 
CV Don Chris: folds 
Lorpugo: folds 
Uncalled bet ($0.04) returned to Keremsen88
Keremsen88 collected $0.05 from pot
*** SUMMARY ***
Total pot $0.05 | Rake $0 
Seat 1: Buhbbj folded before Flop (didn't bet)
Seat 2: Keremsen88 collected ($0.05)
Seat 3: nekro211986 (button) folded before Flop (didn't bet)
Seat 4: CV Don Chris (small blind) folded before Flop
Seat 5: Lorpugo (big blind) folded before Flop



PokerStars Hand #240734757638:  Hold'em No Limit ($0.01/$0.02 USD) - 2022/12/27 15:55:30 ET
Table 'Ilsebill' 6-max Seat #4 is the button
Seat 1: Buhbbj ($1.06 in chips) 
Seat 2: Keremsen88 ($1.30 in chips) 
Seat 3: nekro211986 ($2.67 in chips) 
Seat 4: CV Don Chris ($2.14 in chips) 
Seat 5: Lorpugo ($2.35 in chips) 
Lorpugo: posts small blind $0.01
Buhbbj: posts big blind $0.02
*** HOLE CARDS ***
Dealt to Lorpugo [4d Ks]
Keremsen88: calls $0.02
nekro211986: folds 
nekro211986 leaves the table
CV Don Chris: raises $0.04 to $0.06
Lorpugo: folds 
Buhbbj: folds 
Keremsen88: calls $0.04
*** FLOP *** [Ts 6h Ad]
Paintrain-84 joins the table at seat #3 
Keremsen88: checks 
CV Don Chris: bets $0.09
Keremsen88: calls $0.09
*** TURN *** [Ts 6h Ad] [6c]
Keremsen88: checks 
CV Don Chris: bets $0.12
Keremsen88: calls $0.12
*** RIVER *** [Ts 6h Ad 6c] [9c]
Keremsen88: checks 
CV Don Chris: bets $0.18
Keremsen88: calls $0.18
*** SHOW DOWN ***
CV Don Chris: shows [5d Ah] (two pair, Aces and Sixes)
Keremsen88: shows [2c As] (two pair, Aces and Sixes)
Keremsen88 collected $0.45 from pot
CV Don Chris collected $0.45 from pot
Cortez118 leaves the table
*** SUMMARY ***
Total pot $0.93 | Rake $0.03 
Board [Ts 6h Ad 6c 9c]
Seat 1: Buhbbj (big blind) folded before Flop
Seat 2: Keremsen88 showed [2c As] and won ($0.45) with two pair, Aces and Sixes
Seat 3: nekro211986 folded before Flop (didn't bet)
Seat 4: CV Don Chris (button) showed [5d Ah] and won ($0.45) with two pair, Aces and Sixes
Seat 5: Lorpugo (small blind) folded before Flop



PokerStars Hand #240734773584:  Hold'em No Limit ($0.01/$0.02 USD) - 2022/12/27 15:56:21 ET
Table 'Ilsebill' 6-max Seat #5 is the button
Seat 1: Buhbbj ($1.04 in chips) 
Seat 2: Keremsen88 ($1.30 in chips) 
Seat 3: Paintrain-84 ($0.80 in chips) 
Seat 4: CV Don Chris ($2.14 in chips) 
Seat 5: Lorpugo ($2.34 in chips) 
Buhbbj: posts small blind $0.01
Keremsen88: posts big blind $0.02
Paintrain-84: posts big blind $0.02
*** HOLE CARDS ***
Dealt to Lorpugo [4d Kd]
Paintrain-84: checks 
CV Don Chris: folds 
Lorpugo: calls $0.02
Buhbbj: raises $0.02 to $0.04
Keremsen88: folds 
Paintrain-84: calls $0.02
Shakti9 joins the table at seat #6 
Lorpugo: calls $0.02
*** FLOP *** [Ah Jh 6c]
Buhbbj: checks 
Paintrain-84: checks 
Lorpugo: checks 
*** TURN *** [Ah Jh 6c] [3c]
Buhbbj: bets $0.02
Paintrain-84: calls $0.02
Lorpugo: folds 
*** RIVER *** [Ah Jh 6c 3c] [5h]
Buhbbj: bets $0.02
Paintrain-84: raises $0.11 to $0.13
Buhbbj: raises $0.22 to $0.35
Paintrain-84: raises $0.39 to $0.74 and is all-in
Buhbbj: calls $0.39
*** SHOW DOWN ***
Paintrain-84: shows [2h 4h] (a flush, Ace high)
Buhbbj: shows [5c Ad] (two pair, Aces and Fives)
Paintrain-84 collected $1.58 from pot
*** SUMMARY ***
Total pot $1.66 | Rake $0.08 
Board [Ah Jh 6c 3c 5h]
Seat 1: Buhbbj (small blind) showed [5c Ad] and lost with two pair, Aces and Fives
Seat 2: Keremsen88 (big blind) folded before Flop
Seat 3: Paintrain-84 showed [2h 4h] and won ($1.58) with a flush, Ace high
Seat 4: CV Don Chris folded before Flop (didn't bet)
Seat 5: Lorpugo (button) folded on the Turn



PokerStars Hand #240734791623:  Hold'em No Limit ($0.01/$0.02 USD) - 2022/12/27 15:57:17 ET
Table 'Ilsebill' 6-max Seat #1 is the button
Seat 1: Buhbbj ($0.24 in chips) 
Seat 2: Keremsen88 ($1.28 in chips) 
Seat 3: Paintrain-84 ($1.58 in chips) 
Seat 4: CV Don Chris ($2.14 in chips) 
Seat 5: Lorpugo ($2.30 in chips) 
Keremsen88: posts small blind $0.01
Paintrain-84: posts big blind $0.02
*** HOLE CARDS ***
Dealt to Lorpugo [6c Js]
CV Don Chris: folds 
Lorpugo: folds 
Buhbbj: folds 
Keremsen88: folds 
Uncalled bet ($0.01) returned to Paintrain-84
Paintrain-84 collected $0.02 from pot
*** SUMMARY ***
Total pot $0.02 | Rake $0 
Seat 1: Buhbbj (button) folded before Flop (didn't bet)
Seat 2: Keremsen88 (small blind) folded before Flop
Seat 3: Paintrain-84 (big blind) collected ($0.02)
Seat 4: CV Don Chris folded before Flop (didn't bet)
Seat 5: Lorpugo folded before Flop (didn't bet)



PokerStars Hand #240734797931:  Hold'em No Limit ($0.01/$0.02 USD) - 2022/12/27 15:57:37 ET
Table 'Ilsebill' 6-max Seat #2 is the button
Seat 1: Buhbbj ($0.24 in chips) 
Seat 2: Keremsen88 ($1.27 in chips) 
Seat 3: Paintrain-84 ($1.59 in chips) 
Seat 4: CV Don Chris ($2.14 in chips) 
Seat 5: Lorpugo ($2.30 in chips) 
Seat 6: Shakti9 ($2 in chips) 
Paintrain-84: posts small blind $0.01
CV Don Chris: posts big blind $0.02
Shakti9: posts big blind $0.02
*** HOLE CARDS ***
Dealt to Lorpugo [5s Ad]
Lorpugo: folds 
Shakti9: raises $0.04 to $0.06
Buhbbj: folds 
Keremsen88: calls $0.06
Paintrain-84: folds 
CV Don Chris: folds 
*** FLOP *** [9c 3h Jc]
Shakti9: bets $0.07
Keremsen88: folds 
Uncalled bet ($0.07) returned to Shakti9
Shakti9 collected $0.14 from pot
Shakti9: doesn't show hand 
*** SUMMARY ***
Total pot $0.15 | Rake $0.01 
Board [9c 3h Jc]
Seat 1: Buhbbj folded before Flop (didn't bet)
Seat 2: Keremsen88 (button) folded on the Flop
Seat 3: Paintrain-84 (small blind) folded before Flop
Seat 4: CV Don Chris (big blind) folded before Flop
Seat 5: Lorpugo folded before Flop (didn't bet)
Seat 6: Shakti9 collected ($0.14)



PokerStars Hand #240734804955:  Hold'em No Limit ($0.01/$0.02 USD) - 2022/12/27 15:57:59 ET
Table 'Ilsebill' 6-max Seat #3 is the button
Seat 1: Buhbbj ($0.24 in chips) 
Seat 2: Keremsen88 ($1.21 in chips) 
Seat 3: Paintrain-84 ($1.58 in chips) 
Seat 4: CV Don Chris ($2.12 in chips) 
Seat 5: Lorpugo ($2.30 in chips) 
Seat 6: Shakti9 ($2.08 in chips) 
CV Don Chris: posts small blind $0.01
Lorpugo: posts big blind $0.02
*** HOLE CARDS ***
Dealt to Lorpugo [6d 9c]
Shakti9: folds 
Buhbbj: raises $0.22 to $0.24 and is all-in
Keremsen88: folds 
Paintrain-84: folds 
CV Don Chris: folds 
Lorpugo: folds 
Uncalled bet ($0.22) returned to Buhbbj
Buhbbj collected $0.05 from pot
*** SUMMARY ***
Total pot $0.05 | Rake $0 
Seat 1: Buhbbj collected ($0.05)
Seat 2: Keremsen88 folded before Flop (didn't bet)
Seat 3: Paintrain-84 (button) folded before Flop (didn't bet)
Seat 4: CV Don Chris (small blind) folded before Flop
Seat 5: Lorpugo (big blind) folded before Flop
Seat 6: Shakti9 folded before Flop (didn't bet)



PokerStars Hand #240734810295:  Hold'em No Limit ($0.01/$0.02 USD) - 2022/12/27 15:58:15 ET
Table 'Ilsebill' 6-max Seat #4 is the button
Seat 1: Buhbbj ($0.27 in chips) 
Seat 2: Keremsen88 ($1.21 in chips) 
Seat 3: Paintrain-84 ($1.58 in chips) 
Seat 4: CV Don Chris ($2.11 in chips) 
Seat 5: Lorpugo ($2.28 in chips) 
Seat 6: Shakti9 ($2.08 in chips) 
Lorpugo: posts small blind $0.01
Shakti9: posts big blind $0.02
*** HOLE CARDS ***
Dealt to Lorpugo [5s 4c]
Buhbbj: calls $0.02
Keremsen88: calls $0.02
Paintrain-84: folds 
CV Don Chris: raises $0.04 to $0.06
Lorpugo: folds 
Shakti9: calls $0.04
Buhbbj: raises $0.21 to $0.27 and is all-in
Keremsen88: calls $0.25
CV Don Chris: folds 
Shakti9: folds 
Keremsen88 has timed out
*** FLOP *** [Ac 4d 3c]
*** TURN *** [Ac 4d 3c] [9h]
*** RIVER *** [Ac 4d 3c 9h] [Qs]
*** SHOW DOWN ***
Buhbbj: shows [Ks Jc] (high card Ace)
Keremsen88: shows [Th Jh] (high card Ace - lower kicker)
Buhbbj collected $0.65 from pot
*** SUMMARY ***
Total pot $0.67 | Rake $0.02 
Board [Ac 4d 3c 9h Qs]
Seat 1: Buhbbj showed [Ks Jc] and won ($0.65) with high card Ace
Seat 2: Keremsen88 showed [Th Jh] and lost with high card Ace
Seat 3: Paintrain-84 folded before Flop (didn't bet)
Seat 4: CV Don Chris (button) folded before Flop
Seat 5: Lorpugo (small blind) folded before Flop
Seat 6: Shakti9 (big blind) folded before Flop



PokerStars Hand #240734833463:  Hold'em No Limit ($0.01/$0.02 USD) - 2022/12/27 15:59:27 ET
Table 'Ilsebill' 6-max Seat #5 is the button
Seat 1: Buhbbj ($0.65 in chips) 
Seat 2: Keremsen88 ($0.94 in chips) 
Seat 3: Paintrain-84 ($1.58 in chips) 
Seat 4: CV Don Chris ($2.05 in chips) 
Seat 5: Lorpugo ($2.27 in chips) 
Seat 6: Shakti9 ($2.02 in chips) 
Shakti9: posts small blind $0.01
Buhbbj: posts big blind $0.02
*** HOLE CARDS ***
Dealt to Lorpugo [3c 5d]
Keremsen88: folds 
Paintrain-84: calls $0.02
CV Don Chris has timed out
CV Don Chris: folds 
Lorpugo: folds 
Shakti9: calls $0.01
Buhbbj: checks 
*** FLOP *** [3s 6s 7c]
Shakti9: bets $0.02
Buhbbj: raises $0.02 to $0.04
Paintrain-84: calls $0.04
Shakti9: calls $0.02
*** TURN *** [3s 6s 7c] [Td]
Shakti9: checks 
Buhbbj: checks 
Paintrain-84: checks 
*** RIVER *** [3s 6s 7c Td] [6c]
Shakti9: bets $0.04
Buhbbj: raises $0.55 to $0.59 and is all-in
Paintrain-84: calls $0.59
Shakti9: folds 
*** SHOW DOWN ***
Buhbbj: shows [8s 8h] (two pair, Eights and Sixes)
Paintrain-84: shows [6h Ac] (three of a kind, Sixes)
Paintrain-84 collected $1.34 from pot
*** SUMMARY ***
Total pot $1.40 | Rake $0.06 
Board [3s 6s 7c Td 6c]
Seat 1: Buhbbj (big blind) showed [8s 8h] and lost with two pair, Eights and Sixes
Seat 2: Keremsen88 folded before Flop (didn't bet)
Seat 3: Paintrain-84 showed [6h Ac] and won ($1.34) with three of a kind, Sixes
Seat 4: CV Don Chris folded before Flop (didn't bet)
Seat 5: Lorpugo (button) folded before Flop (didn't bet)
Seat 6: Shakti9 (small blind) folded on the River



PokerStars Hand #240734859159:  Hold'em No Limit ($0.01/$0.02 USD) - 2022/12/27 16:00:43 ET
Table 'Ilsebill' 6-max Seat #6 is the button
Seat 2: Keremsen88 ($0.94 in chips) 
Seat 3: Paintrain-84 ($2.27 in chips) 
Seat 5: Lorpugo ($2.27 in chips) 
Seat 6: Shakti9 ($1.92 in chips) 
Keremsen88: posts small blind $0.01
Paintrain-84: posts big blind $0.02
*** HOLE CARDS ***
Dealt to Lorpugo [6s 2d]
Lorpugo: folds 
Buhbbj leaves the table
szpaki joins the table at seat #1 
Shakti9: folds 
Keremsen88: raises $0.04 to $0.06
Paintrain-84: calls $0.04
*** FLOP *** [Kh 4c 6c]
Keremsen88: checks 
Paintrain-84: checks 
*** TURN *** [Kh 4c 6c] [3s]
Keremsen88: bets $0.02
Paintrain-84: calls $0.02
*** RIVER *** [Kh 4c 6c 3s] [Qs]
Keremsen88: checks 
Paintrain-84: checks 
*** SHOW DOWN ***
Keremsen88: shows [Ts Ac] (high card Ace)
Paintrain-84: mucks hand 
Keremsen88 collected $0.15 from pot
*** SUMMARY ***
Total pot $0.16 | Rake $0.01 
Board [Kh 4c 6c 3s Qs]
Seat 2: Keremsen88 (small blind) showed [Ts Ac] and won ($0.15) with high card Ace
Seat 3: Paintrain-84 (big blind) mucked [Jc 2c]
Seat 5: Lorpugo folded before Flop (didn't bet)
Seat 6: Shakti9 (button) folded before Flop (didn't bet)



PokerStars Hand #240734871054:  Hold'em No Limit ($0.01/$0.02 USD) - 2022/12/27 16:01:15 ET
Table 'Ilsebill' 6-max Seat #2 is the button
Seat 2: Keremsen88 ($1.01 in chips) 
Seat 3: Paintrain-84 ($2.19 in chips) 
Seat 4: CV Don Chris ($2.05 in chips) 
Seat 5: Lorpugo ($2.27 in chips) 
Seat 6: Shakti9 ($1.92 in chips) 
Paintrain-84: posts small blind $0.01
CV Don Chris: posts big blind $0.02
*** HOLE CARDS ***
Dealt to Lorpugo [8c 2h]
Lorpugo: folds 
Shakti9: raises $0.02 to $0.04
Keremsen88: folds 
Paintrain-84: calls $0.03
CV Don Chris: calls $0.02
*** FLOP *** [5h Ts 5d]
Paintrain-84: checks 
CV Don Chris: checks 
Shakti9: bets $0.10
Paintrain-84: calls $0.10
CV Don Chris: folds 
*** TURN *** [5h Ts 5d] [9s]
Paintrain-84: checks 
Shakti9: checks 
*** RIVER *** [5h Ts 5d 9s] [4d]
Paintrain-84: checks 
Shakti9: checks 
*** SHOW DOWN ***
Paintrain-84: shows [8d Td] (two pair, Tens and Fives)
Shakti9: mucks hand 
Paintrain-84 collected $0.31 from pot
*** SUMMARY ***
Total pot $0.32 | Rake $0.01 
Board [5h Ts 5d 9s 4d]
Seat 2: Keremsen88 (button) folded before Flop (didn't bet)
Seat 3: Paintrain-84 (small blind) showed [8d Td] and won ($0.31) with two pair, Tens and Fives
Seat 4: CV Don Chris (big blind) folded on the Flop
Seat 5: Lorpugo folded before Flop (didn't bet)
Seat 6: Shakti9 mucked [6c 6h]



PokerStars Hand #240734887762:  Hold'em No Limit ($0.01/$0.02 USD) - 2022/12/27 16:01:55 ET
Table 'Ilsebill' 6-max Seat #3 is the button
Seat 2: Keremsen88 ($1.01 in chips) 
Seat 3: Paintrain-84 ($2.36 in chips) 
Seat 4: CV Don Chris ($2.01 in chips) 
Seat 5: Lorpugo ($2.27 in chips) 
Seat 6: Shakti9 ($1.78 in chips) 
CV Don Chris: posts small blind $0.01
Lorpugo: posts big blind $0.02
*** HOLE CARDS ***
Dealt to Lorpugo [Ts 2h]
Shakti9: raises $0.04 to $0.06
Keremsen88: folds 
Paintrain-84: folds 
CV Don Chris: calls $0.05
Lorpugo: folds 
*** FLOP *** [4c Kh 6c]
CV Don Chris: bets $0.07
Shakti9: raises $0.28 to $0.35
CV Don Chris: calls $0.28
*** TURN *** [4c Kh 6c] [3s]
CV Don Chris: checks 
Shakti9: bets $0.81
CV Don Chris: folds 
Uncalled bet ($0.81) returned to Shakti9
Shakti9 collected $0.81 from pot
Shakti9: doesn't show hand 
*** SUMMARY ***
Total pot $0.84 | Rake $0.03 
Board [4c Kh 6c 3s]
Seat 2: Keremsen88 folded before Flop (didn't bet)
Seat 3: Paintrain-84 (button) folded before Flop (didn't bet)
Seat 4: CV Don Chris (small blind) folded on the Turn
Seat 5: Lorpugo (big blind) folded before Flop
Seat 6: Shakti9 collected ($0.81)



PokerStars Hand #240734922049:  Hold'em No Limit ($0.01/$0.02 USD) - 2022/12/27 16:03:08 ET
Table 'Ilsebill' 6-max Seat #4 is the button
Seat 2: Keremsen88 ($1.01 in chips) 
Seat 3: Paintrain-84 ($2.36 in chips) 
Seat 4: CV Don Chris ($2 in chips) 
Seat 5: Lorpugo ($2.25 in chips) 
Seat 6: Shakti9 ($2.18 in chips) 
Lorpugo: posts small blind $0.01
Shakti9: posts big blind $0.02
*** HOLE CARDS ***
Dealt to Lorpugo [Qh 3h]
Keremsen88: raises $0.04 to $0.06
Paintrain-84: folds 
CV Don Chris: calls $0.06
Lorpugo: folds 
Shakti9: folds 
*** FLOP *** [Kh 3s Ac]
Keremsen88: bets $0.07
CV Don Chris: calls $0.07
*** TURN *** [Kh 3s Ac] [8s]
Keremsen88: bets $0.28
CV Don Chris: folds 
Uncalled bet ($0.28) returned to Keremsen88
Keremsen88 collected $0.28 from pot
*** SUMMARY ***
Total pot $0.29 | Rake $0.01 
Board [Kh 3s Ac 8s]
Seat 2: Keremsen88 collected ($0.28)
Seat 3: Paintrain-84 folded before Flop (didn't bet)
Seat 4: CV Don Chris (button) folded on the Turn
Seat 5: Lorpugo (small blind) folded before Flop
Seat 6: Shakti9 (big blind) folded before Flop



PokerStars Hand #240734941157:  Hold'em No Limit ($0.01/$0.02 USD) - 2022/12/27 16:03:47 ET
Table 'Ilsebill' 6-max Seat #5 is the button
Seat 1: szpaki ($2 in chips) 
Seat 2: Keremsen88 ($1.16 in chips) 
Seat 3: Paintrain-84 ($2.36 in chips) 
Seat 4: CV Don Chris ($2 in chips) 
Seat 5: Lorpugo ($2.24 in chips) 
Seat 6: Shakti9 ($2.16 in chips) 
Shakti9: posts small blind $0.01
szpaki: posts big blind $0.02
*** HOLE CARDS ***
Dealt to Lorpugo [2d 2s]
Keremsen88: calls $0.02
Paintrain-84: calls $0.02
CV Don Chris: folds 
Lorpugo: calls $0.02
Shakti9: calls $0.01
szpaki: checks 
*** FLOP *** [8s 4h Kc]
Shakti9: checks 
szpaki: checks 
Keremsen88: checks 
Paintrain-84: bets $0.07
Lorpugo: folds 
Shakti9: folds 
szpaki: folds 
Keremsen88: folds 
Uncalled bet ($0.07) returned to Paintrain-84
Paintrain-84 collected $0.10 from pot
*** SUMMARY ***
Total pot $0.10 | Rake $0 
Board [8s 4h Kc]
Seat 1: szpaki (big blind) folded on the Flop
Seat 2: Keremsen88 folded on the Flop
Seat 3: Paintrain-84 collected ($0.10)
Seat 4: CV Don Chris folded before Flop (didn't bet)
Seat 5: Lorpugo (button) folded on the Flop
Seat 6: Shakti9 (small blind) folded on the Flop



PokerStars Hand #240734960833:  Hold'em No Limit ($0.01/$0.02 USD) - 2022/12/27 16:04:28 ET
Table 'Ilsebill' 6-max Seat #6 is the button
Seat 1: szpaki ($1.98 in chips) 
Seat 2: Keremsen88 ($1.14 in chips) 
Seat 3: Paintrain-84 ($2.44 in chips) 
Seat 4: CV Don Chris ($2 in chips) 
Seat 5: Lorpugo ($2.22 in chips) 
Seat 6: Shakti9 ($2.14 in chips) 
szpaki: posts small blind $0.01
Keremsen88: posts big blind $0.02
*** HOLE CARDS ***
Dealt to Lorpugo [Qd 6c]
Paintrain-84: folds 
CV Don Chris: folds 
Lorpugo: folds 
Shakti9: raises $0.02 to $0.04
szpaki: folds 
Keremsen88: calls $0.02
*** FLOP *** [Js 8c Qs]
Keremsen88: checks 
Shakti9: checks 
*** TURN *** [Js 8c Qs] [5s]
Keremsen88: checks 
Shakti9: checks 
*** RIVER *** [Js 8c Qs 5s] [4s]
Keremsen88: checks 
Shakti9: bets $0.02
Keremsen88: folds 
Uncalled bet ($0.02) returned to Shakti9
Shakti9 collected $0.09 from pot
Shakti9: doesn't show hand 
*** SUMMARY ***
Total pot $0.09 | Rake $0 
Board [Js 8c Qs 5s 4s]
Seat 1: szpaki (small blind) folded before Flop
Seat 2: Keremsen88 (big blind) folded on the River
Seat 3: Paintrain-84 folded before Flop (didn't bet)
Seat 4: CV Don Chris folded before Flop (didn't bet)
Seat 5: Lorpugo folded before Flop (didn't bet)
Seat 6: Shakti9 (button) collected ($0.09)



PokerStars Hand #240734991821:  Hold'em No Limit ($0.01/$0.02 USD) - 2022/12/27 16:05:31 ET
Table 'Ilsebill' 6-max Seat #1 is the button
Seat 1: szpaki ($1.97 in chips) 
Seat 2: Keremsen88 ($1.10 in chips) 
Seat 3: Paintrain-84 ($2.44 in chips) 
Seat 4: CV Don Chris ($2 in chips) 
Seat 5: Lorpugo ($2.22 in chips) 
Seat 6: Shakti9 ($2.19 in chips) 
Keremsen88: posts small blind $0.01
Paintrain-84: posts big blind $0.02
*** HOLE CARDS ***
Dealt to Lorpugo [7h Ks]
CV Don Chris: raises $0.04 to $0.06
Lorpugo: folds 
Shakti9: folds 
szpaki: folds 
Keremsen88: folds 
Paintrain-84: folds 
Uncalled bet ($0.04) returned to CV Don Chris
CV Don Chris collected $0.05 from pot
*** SUMMARY ***
Total pot $0.05 | Rake $0 
Seat 1: szpaki (button) folded before Flop (didn't bet)
Seat 2: Keremsen88 (small blind) folded before Flop
Seat 3: Paintrain-84 (big blind) folded before Flop
Seat 4: CV Don Chris collected ($0.05)
Seat 5: Lorpugo folded before Flop (didn't bet)
Seat 6: Shakti9 folded before Flop (didn't bet)



