PokerStars Hand #241658703109: Tournament #3543831745, $0.92+$0.08 USD Hold'em No Limit - Level I (10/20) - 2023/02/06 13:13:10 ET
Table '3543831745 1' 3-max Seat #1 is the button
Seat 1: Lorpugo (500 in chips) 
Seat 2: basil8819 (500 in chips) 
Seat 3: tibixfuvar (500 in chips) 
basil8819: posts small blind 10
tibixfuvar: posts big blind 20
*** HOLE CARDS ***
Dealt to Lorpugo [8d Ad]
Lorpugo: raises 30 to 50
basil8819: calls 40
tibixfuvar: raises 150 to 200
Lorpugo: folds 
basil8819: folds 
Uncalled bet (150) returned to tibixfuvar
tibixfuvar collected 150 from pot
tibixfuvar: doesn't show hand 
*** SUMMARY ***
Total pot 150 | Rake 0 
Seat 1: Lorpugo (button) folded before Flop
Seat 2: basil8819 (small blind) folded before Flop
Seat 3: tibixfuvar (big blind) collected (150)



PokerStars Hand #241658710950: Tournament #3543831745, $0.92+$0.08 USD Hold'em No Limit - Level I (10/20) - 2023/02/06 13:13:30 ET
Table '3543831745 1' 3-max Seat #2 is the button
Seat 1: Lorpugo (450 in chips) 
Seat 2: basil8819 (450 in chips) 
Seat 3: tibixfuvar (600 in chips) 
tibixfuvar: posts small blind 10
Lorpugo: posts big blind 20
*** HOLE CARDS ***
Dealt to Lorpugo [3c 7h]
basil8819: calls 20
tibixfuvar: raises 40 to 60
Lorpugo: folds 
basil8819: calls 40
*** FLOP *** [6s 8s 8d]
tibixfuvar: bets 70
basil8819: folds 
Uncalled bet (70) returned to tibixfuvar
tibixfuvar collected 140 from pot
tibixfuvar: doesn't show hand 
*** SUMMARY ***
Total pot 140 | Rake 0 
Board [6s 8s 8d]
Seat 1: Lorpugo (big blind) folded before Flop
Seat 2: basil8819 (button) folded on the Flop
Seat 3: tibixfuvar (small blind) collected (140)



PokerStars Hand #241658718161: Tournament #3543831745, $0.92+$0.08 USD Hold'em No Limit - Level I (10/20) - 2023/02/06 13:13:49 ET
Table '3543831745 1' 3-max Seat #3 is the button
Seat 1: Lorpugo (430 in chips) 
Seat 2: basil8819 (390 in chips) 
Seat 3: tibixfuvar (680 in chips) 
Lorpugo: posts small blind 10
basil8819: posts big blind 20
*** HOLE CARDS ***
Dealt to Lorpugo [Ac 6h]
tibixfuvar: raises 40 to 60
Lorpugo: calls 50
basil8819: folds 
*** FLOP *** [9c Ah 8c]
Lorpugo: checks 
tibixfuvar: bets 70
Lorpugo: calls 70
*** TURN *** [9c Ah 8c] [3c]
Lorpugo: checks 
tibixfuvar: bets 140
Lorpugo: raises 160 to 300 and is all-in
tibixfuvar: calls 160
*** RIVER *** [9c Ah 8c 3c] [3d]
*** SHOW DOWN ***
Lorpugo: shows [Ac 6h] (two pair, Aces and Threes)
tibixfuvar: shows [Ad 7c] (two pair, Aces and Threes)
Lorpugo collected 440 from pot
tibixfuvar collected 440 from pot
*** SUMMARY ***
Total pot 880 | Rake 0 
Board [9c Ah 8c 3c 3d]
Seat 1: Lorpugo (small blind) showed [Ac 6h] and won (440) with two pair, Aces and Threes
Seat 2: basil8819 (big blind) folded before Flop
Seat 3: tibixfuvar (button) showed [Ad 7c] and won (440) with two pair, Aces and Threes



PokerStars Hand #241658735153: Tournament #3543831745, $0.92+$0.08 USD Hold'em No Limit - Level I (10/20) - 2023/02/06 13:14:33 ET
Table '3543831745 1' 3-max Seat #1 is the button
Seat 1: Lorpugo (440 in chips) 
Seat 2: basil8819 (370 in chips) 
Seat 3: tibixfuvar (690 in chips) 
basil8819: posts small blind 10
tibixfuvar: posts big blind 20
*** HOLE CARDS ***
Dealt to Lorpugo [3s 3c]
Lorpugo: raises 20 to 40
basil8819: calls 30
tibixfuvar: calls 20
*** FLOP *** [6d 2d 5h]
basil8819: checks 
tibixfuvar: bets 120
Lorpugo: folds 
basil8819: folds 
Uncalled bet (120) returned to tibixfuvar
tibixfuvar collected 120 from pot
tibixfuvar: doesn't show hand 
*** SUMMARY ***
Total pot 120 | Rake 0 
Board [6d 2d 5h]
Seat 1: Lorpugo (button) folded on the Flop
Seat 2: basil8819 (small blind) folded on the Flop
Seat 3: tibixfuvar (big blind) collected (120)



PokerStars Hand #241658744889: Tournament #3543831745, $0.92+$0.08 USD Hold'em No Limit - Level I (10/20) - 2023/02/06 13:14:58 ET
Table '3543831745 1' 3-max Seat #2 is the button
Seat 1: Lorpugo (400 in chips) 
Seat 2: basil8819 (330 in chips) 
Seat 3: tibixfuvar (770 in chips) 
tibixfuvar: posts small blind 10
Lorpugo: posts big blind 20
*** HOLE CARDS ***
Dealt to Lorpugo [2d 3h]
basil8819: calls 20
tibixfuvar: calls 10
Lorpugo: checks 
*** FLOP *** [Ts 3d 2c]
tibixfuvar: checks 
Lorpugo: checks 
basil8819: bets 310 and is all-in
tibixfuvar: folds 
Lorpugo: calls 310
*** TURN *** [Ts 3d 2c] [4c]
*** RIVER *** [Ts 3d 2c 4c] [3s]
*** SHOW DOWN ***
Lorpugo: shows [2d 3h] (a full house, Threes full of Deuces)
basil8819: shows [2h 4h] (two pair, Fours and Threes)
Lorpugo collected 680 from pot
basil8819 finished the tournament in 3rd place
*** SUMMARY ***
Total pot 680 | Rake 0 
Board [Ts 3d 2c 4c 3s]
Seat 1: Lorpugo (big blind) showed [2d 3h] and won (680) with a full house, Threes full of Deuces
Seat 2: basil8819 (button) showed [2h 4h] and lost with two pair, Fours and Threes
Seat 3: tibixfuvar (small blind) folded on the Flop



PokerStars Hand #241658755375: Tournament #3543831745, $0.92+$0.08 USD Hold'em No Limit - Level II (15/30) - 2023/02/06 13:15:25 ET
Table '3543831745 1' 3-max Seat #1 is the button
Seat 1: Lorpugo (750 in chips) 
Seat 3: tibixfuvar (750 in chips) 
Lorpugo: posts small blind 15
tibixfuvar: posts big blind 30
*** HOLE CARDS ***
Dealt to Lorpugo [Qs 7d]
Lorpugo: raises 30 to 60
tibixfuvar: calls 30
*** FLOP *** [8d Jc 4h]
tibixfuvar: checks 
Lorpugo: bets 40
tibixfuvar: raises 40 to 80
Lorpugo: calls 40
*** TURN *** [8d Jc 4h] [5d]
tibixfuvar: bets 90
Lorpugo: calls 90
*** RIVER *** [8d Jc 4h 5d] [4s]
tibixfuvar: bets 230
Lorpugo: folds 
Uncalled bet (230) returned to tibixfuvar
tibixfuvar collected 460 from pot
tibixfuvar: doesn't show hand 
*** SUMMARY ***
Total pot 460 | Rake 0 
Board [8d Jc 4h 5d 4s]
Seat 1: Lorpugo (button) (small blind) folded on the River
Seat 3: tibixfuvar (big blind) collected (460)



PokerStars Hand #241658772469: Tournament #3543831745, $0.92+$0.08 USD Hold'em No Limit - Level II (15/30) - 2023/02/06 13:16:09 ET
Table '3543831745 1' 3-max Seat #3 is the button
Seat 1: Lorpugo (520 in chips) 
Seat 3: tibixfuvar (980 in chips) 
tibixfuvar: posts small blind 15
Lorpugo: posts big blind 30
*** HOLE CARDS ***
Dealt to Lorpugo [8c 4c]
tibixfuvar: calls 15
Lorpugo: checks 
*** FLOP *** [8d Kh 8h]
Lorpugo: checks 
tibixfuvar: bets 30
Lorpugo: calls 30
*** TURN *** [8d Kh 8h] [Ah]
Lorpugo: checks 
tibixfuvar: checks 
*** RIVER *** [8d Kh 8h Ah] [9h]
Lorpugo: checks 
tibixfuvar: checks 
*** SHOW DOWN ***
Lorpugo: shows [8c 4c] (three of a kind, Eights)
tibixfuvar: shows [9c 5h] (a flush, Ace high)
tibixfuvar collected 120 from pot
*** SUMMARY ***
Total pot 120 | Rake 0 
Board [8d Kh 8h Ah 9h]
Seat 1: Lorpugo (big blind) showed [8c 4c] and lost with three of a kind, Eights
Seat 3: tibixfuvar (button) (small blind) showed [9c 5h] and won (120) with a flush, Ace high



PokerStars Hand #241658781995: Tournament #3543831745, $0.92+$0.08 USD Hold'em No Limit - Level II (15/30) - 2023/02/06 13:16:34 ET
Table '3543831745 1' 3-max Seat #1 is the button
Seat 1: Lorpugo (460 in chips) 
Seat 3: tibixfuvar (1040 in chips) 
Lorpugo: posts small blind 15
tibixfuvar: posts big blind 30
*** HOLE CARDS ***
Dealt to Lorpugo [Jc 7d]
Lorpugo: raises 30 to 60
tibixfuvar: calls 30
*** FLOP *** [6h 4h 7h]
tibixfuvar: checks 
Lorpugo: bets 150
tibixfuvar: calls 150
*** TURN *** [6h 4h 7h] [5c]
tibixfuvar: checks 
Lorpugo: checks 
*** RIVER *** [6h 4h 7h 5c] [8d]
tibixfuvar: bets 420
Lorpugo: calls 250 and is all-in
Uncalled bet (170) returned to tibixfuvar
*** SHOW DOWN ***
tibixfuvar: shows [Ts 8h] (a straight, Four to Eight)
Lorpugo: shows [Jc 7d] (a straight, Four to Eight)
tibixfuvar collected 460 from pot
Lorpugo collected 460 from pot
*** SUMMARY ***
Total pot 920 | Rake 0 
Board [6h 4h 7h 5c 8d]
Seat 1: Lorpugo (button) (small blind) showed [Jc 7d] and won (460) with a straight, Four to Eight
Seat 3: tibixfuvar (big blind) showed [Ts 8h] and won (460) with a straight, Four to Eight



PokerStars Hand #241658798016: Tournament #3543831745, $0.92+$0.08 USD Hold'em No Limit - Level III (20/40) - 2023/02/06 13:17:15 ET
Table '3543831745 1' 3-max Seat #3 is the button
Seat 1: Lorpugo (460 in chips) 
Seat 3: tibixfuvar (1040 in chips) 
tibixfuvar: posts small blind 20
Lorpugo: posts big blind 40
*** HOLE CARDS ***
Dealt to Lorpugo [Js 4d]
tibixfuvar: calls 20
Lorpugo: checks 
*** FLOP *** [7s 3c 6c]
Lorpugo: checks 
tibixfuvar: bets 40
Lorpugo: calls 40
*** TURN *** [7s 3c 6c] [Tc]
Lorpugo: checks 
tibixfuvar: checks 
*** RIVER *** [7s 3c 6c Tc] [Qc]
Lorpugo: bets 106
tibixfuvar: folds 
Uncalled bet (106) returned to Lorpugo
Lorpugo collected 160 from pot
Lorpugo: doesn't show hand 
*** SUMMARY ***
Total pot 160 | Rake 0 
Board [7s 3c 6c Tc Qc]
Seat 1: Lorpugo (big blind) collected (160)
Seat 3: tibixfuvar (button) (small blind) folded on the River



PokerStars Hand #241658807409: Tournament #3543831745, $0.92+$0.08 USD Hold'em No Limit - Level III (20/40) - 2023/02/06 13:17:39 ET
Table '3543831745 1' 3-max Seat #1 is the button
Seat 1: Lorpugo (540 in chips) 
Seat 3: tibixfuvar (960 in chips) 
Lorpugo: posts small blind 20
tibixfuvar: posts big blind 40
*** HOLE CARDS ***
Dealt to Lorpugo [As 9c]
Lorpugo: calls 20
tibixfuvar: raises 80 to 120
Lorpugo: raises 420 to 540 and is all-in
tibixfuvar: calls 420
*** FLOP *** [2c 7d 7s]
*** TURN *** [2c 7d 7s] [3d]
*** RIVER *** [2c 7d 7s 3d] [5d]
*** SHOW DOWN ***
tibixfuvar: shows [Td Ah] (a pair of Sevens)
Lorpugo: shows [As 9c] (a pair of Sevens - lower kicker)
tibixfuvar collected 1080 from pot
Lorpugo finished the tournament in 2nd place
tibixfuvar wins the tournament and receives $2.00 - congratulations!
*** SUMMARY ***
Total pot 1080 | Rake 0 
Board [2c 7d 7s 3d 5d]
Seat 1: Lorpugo (button) (small blind) showed [As 9c] and lost with a pair of Sevens
Seat 3: tibixfuvar (big blind) showed [Td Ah] and won (1080) with a pair of Sevens



