PokerStars Hand #239467532747:  Hold'em No Limit ($0.01/$0.02 USD) - 2022/10/26 14:09:21 ET
Table 'Proteus III' 6-max Seat #1 is the button
Seat 1: Ubersetzer ($0.46 in chips) 
Seat 2: Gabryelods ($2.37 in chips) 
Seat 3: Lorpugo ($1.60 in chips) 
Seat 4: Jaguar1726 ($1.83 in chips) 
Seat 5: nowisayhello ($2.12 in chips) 
Seat 6: dimon4ek1111 ($1.58 in chips) 
Gabryelods: posts small blind $0.01
Lorpugo: posts big blind $0.02
*** HOLE CARDS ***
Dealt to Lorpugo [6d 9h]
Jaguar1726: folds 
nowisayhello: raises $0.03 to $0.05
dimon4ek1111: folds 
Ubersetzer: folds 
Gabryelods: folds 
Lorpugo: folds 
Uncalled bet ($0.03) returned to nowisayhello
nowisayhello collected $0.05 from pot
nowisayhello: doesn't show hand 
*** SUMMARY ***
Total pot $0.05 | Rake $0 
Seat 1: Ubersetzer (button) folded before Flop (didn't bet)
Seat 2: Gabryelods (small blind) folded before Flop
Seat 3: Lorpugo (big blind) folded before Flop
Seat 4: Jaguar1726 folded before Flop (didn't bet)
Seat 5: nowisayhello collected ($0.05)
Seat 6: dimon4ek1111 folded before Flop (didn't bet)



PokerStars Hand #239467537651:  Hold'em No Limit ($0.01/$0.02 USD) - 2022/10/26 14:09:34 ET
Table 'Proteus III' 6-max Seat #2 is the button
Seat 1: Ubersetzer ($0.46 in chips) 
Seat 2: Gabryelods ($2.36 in chips) 
Seat 3: Lorpugo ($1.60 in chips) 
Seat 4: Jaguar1726 ($1.83 in chips) 
Seat 5: nowisayhello ($2.15 in chips) 
Seat 6: dimon4ek1111 ($1.58 in chips) 
Lorpugo: posts small blind $0.01
Jaguar1726: posts big blind $0.02
*** HOLE CARDS ***
Dealt to Lorpugo [8h Th]
nowisayhello: folds 
dimon4ek1111: raises $0.02 to $0.04
Ubersetzer: folds 
Gabryelods: calls $0.04
Lorpugo: calls $0.03
Jaguar1726: folds 
*** FLOP *** [Qh 6s 8d]
Lorpugo: bets $0.07
dimon4ek1111: folds 
Gabryelods: folds 
Uncalled bet ($0.07) returned to Lorpugo
Lorpugo collected $0.14 from pot
Lorpugo: doesn't show hand 
Jaguar1726 leaves the table
*** SUMMARY ***
Total pot $0.14 | Rake $0 
Board [Qh 6s 8d]
Seat 1: Ubersetzer folded before Flop (didn't bet)
Seat 2: Gabryelods (button) folded on the Flop
Seat 3: Lorpugo (small blind) collected ($0.14)
Seat 4: Jaguar1726 (big blind) folded before Flop
Seat 5: nowisayhello folded before Flop (didn't bet)
Seat 6: dimon4ek1111 folded on the Flop



PokerStars Hand #239467552705:  Hold'em No Limit ($0.01/$0.02 USD) - 2022/10/26 14:10:17 ET
Table 'Proteus III' 6-max Seat #3 is the button
Seat 1: Ubersetzer ($0.46 in chips) 
Seat 2: Gabryelods ($2.32 in chips) 
Seat 3: Lorpugo ($1.70 in chips) 
Seat 5: nowisayhello ($2.15 in chips) 
Seat 6: dimon4ek1111 ($1.54 in chips) 
nowisayhello: posts small blind $0.01
dimon4ek1111: posts big blind $0.02
*** HOLE CARDS ***
Dealt to Lorpugo [7c 7s]
Ubersetzer: folds 
Gabryelods: folds 
Lorpugo: raises $0.04 to $0.06
nowisayhello: folds 
dimon4ek1111: folds 
Uncalled bet ($0.04) returned to Lorpugo
VNNBY joins the table at seat #4 
Lorpugo collected $0.05 from pot
Lorpugo: doesn't show hand 
*** SUMMARY ***
Total pot $0.05 | Rake $0 
Seat 1: Ubersetzer folded before Flop (didn't bet)
Seat 2: Gabryelods folded before Flop (didn't bet)
Seat 3: Lorpugo (button) collected ($0.05)
Seat 5: nowisayhello (small blind) folded before Flop
Seat 6: dimon4ek1111 (big blind) folded before Flop



PokerStars Hand #239467557645:  Hold'em No Limit ($0.01/$0.02 USD) - 2022/10/26 14:10:30 ET
Table 'Proteus III' 6-max Seat #5 is the button
Seat 1: Ubersetzer ($0.46 in chips) 
Seat 2: Gabryelods ($2.32 in chips) 
Seat 3: Lorpugo ($1.73 in chips) 
Seat 5: nowisayhello ($2.14 in chips) 
Seat 6: dimon4ek1111 ($1.52 in chips) 
dimon4ek1111: posts small blind $0.01
Ubersetzer: posts big blind $0.02
VNNBY is connected 
VNNBY: sits out 
*** HOLE CARDS ***
Dealt to Lorpugo [2h 4c]
Gabryelods: folds 
Lorpugo: folds 
nowisayhello: folds 
dimon4ek1111: folds 
Uncalled bet ($0.01) returned to Ubersetzer
Ubersetzer collected $0.02 from pot
Ubersetzer: doesn't show hand 
*** SUMMARY ***
Total pot $0.02 | Rake $0 
Seat 1: Ubersetzer (big blind) collected ($0.02)
Seat 2: Gabryelods folded before Flop (didn't bet)
Seat 3: Lorpugo folded before Flop (didn't bet)
Seat 5: nowisayhello (button) folded before Flop (didn't bet)
Seat 6: dimon4ek1111 (small blind) folded before Flop



PokerStars Hand #239467561896:  Hold'em No Limit ($0.01/$0.02 USD) - 2022/10/26 14:10:42 ET
Table 'Proteus III' 6-max Seat #6 is the button
Seat 1: Ubersetzer ($0.47 in chips) 
Seat 2: Gabryelods ($2.32 in chips) 
Seat 3: Lorpugo ($1.73 in chips) 
Seat 5: nowisayhello ($2.14 in chips) 
Seat 6: dimon4ek1111 ($1.51 in chips) 
Ubersetzer: posts small blind $0.01
Gabryelods: posts big blind $0.02
VNNBY: sits out 
*** HOLE CARDS ***
Dealt to Lorpugo [Jh 2h]
Lorpugo: folds 
nowisayhello: folds 
dimon4ek1111: raises $0.02 to $0.04
Ubersetzer: calls $0.03
Gabryelods: folds 
*** FLOP *** [3d 5d Jd]
Ubersetzer: bets $0.06
dimon4ek1111: calls $0.06
*** TURN *** [3d 5d Jd] [5s]
Ubersetzer: bets $0.11
dimon4ek1111: calls $0.11
*** RIVER *** [3d 5d Jd 5s] [Kh]
Ubersetzer: bets $0.26 and is all-in
dimon4ek1111: folds 
Uncalled bet ($0.26) returned to Ubersetzer
Ubersetzer collected $0.42 from pot
Ubersetzer: doesn't show hand 
*** SUMMARY ***
Total pot $0.44 | Rake $0.02 
Board [3d 5d Jd 5s Kh]
Seat 1: Ubersetzer (small blind) collected ($0.42)
Seat 2: Gabryelods (big blind) folded before Flop
Seat 3: Lorpugo folded before Flop (didn't bet)
Seat 5: nowisayhello folded before Flop (didn't bet)
Seat 6: dimon4ek1111 (button) folded on the River



PokerStars Hand #239467574655:  Hold'em No Limit ($0.01/$0.02 USD) - 2022/10/26 14:11:18 ET
Table 'Proteus III' 6-max Seat #1 is the button
Seat 1: Ubersetzer ($0.68 in chips) 
Seat 2: Gabryelods ($2.30 in chips) 
Seat 3: Lorpugo ($1.73 in chips) 
Seat 5: nowisayhello ($2.14 in chips) 
Seat 6: dimon4ek1111 ($1.30 in chips) 
Gabryelods: posts small blind $0.01
Lorpugo: posts big blind $0.02
VNNBY: sits out 
*** HOLE CARDS ***
Dealt to Lorpugo [3c Ts]
nowisayhello: raises $0.03 to $0.05
dimon4ek1111: calls $0.05
Ubersetzer: folds 
Gabryelods: calls $0.04
Lorpugo: folds 
*** FLOP *** [Ks 9c 7h]
Gabryelods: checks 
nowisayhello: checks 
dimon4ek1111: checks 
*** TURN *** [Ks 9c 7h] [Kd]
Gabryelods: checks 
nowisayhello: checks 
dimon4ek1111: checks 
*** RIVER *** [Ks 9c 7h Kd] [4s]
Gabryelods: bets $0.08
nowisayhello: folds 
dimon4ek1111: folds 
Uncalled bet ($0.08) returned to Gabryelods
Gabryelods collected $0.16 from pot
Gabryelods: doesn't show hand 
*** SUMMARY ***
Total pot $0.17 | Rake $0.01 
Board [Ks 9c 7h Kd 4s]
Seat 1: Ubersetzer (button) folded before Flop (didn't bet)
Seat 2: Gabryelods (small blind) collected ($0.16)
Seat 3: Lorpugo (big blind) folded before Flop
Seat 5: nowisayhello folded on the River
Seat 6: dimon4ek1111 folded on the River



PokerStars Hand #239467596273:  Hold'em No Limit ($0.01/$0.02 USD) - 2022/10/26 14:12:18 ET
Table 'Proteus III' 6-max Seat #2 is the button
Seat 1: Ubersetzer ($0.68 in chips) 
Seat 2: Gabryelods ($2.41 in chips) 
Seat 3: Lorpugo ($1.71 in chips) 
Seat 4: VNNBY ($1.89 in chips) 
Seat 5: nowisayhello ($2.09 in chips) 
Seat 6: dimon4ek1111 ($1.25 in chips) 
Lorpugo: posts small blind $0.01
VNNBY: posts big blind $0.02
*** HOLE CARDS ***
Dealt to Lorpugo [8s 9c]
nowisayhello: folds 
dimon4ek1111: folds 
Ubersetzer: folds 
Gabryelods: folds 
Lorpugo: raises $0.04 to $0.06
VNNBY: folds 
Uncalled bet ($0.04) returned to Lorpugo
Lorpugo collected $0.04 from pot
Lorpugo: doesn't show hand 
*** SUMMARY ***
Total pot $0.04 | Rake $0 
Seat 1: Ubersetzer folded before Flop (didn't bet)
Seat 2: Gabryelods (button) folded before Flop (didn't bet)
Seat 3: Lorpugo (small blind) collected ($0.04)
Seat 4: VNNBY (big blind) folded before Flop
Seat 5: nowisayhello folded before Flop (didn't bet)
Seat 6: dimon4ek1111 folded before Flop (didn't bet)



PokerStars Hand #239467601029:  Hold'em No Limit ($0.01/$0.02 USD) - 2022/10/26 14:12:31 ET
Table 'Proteus III' 6-max Seat #3 is the button
Seat 1: Ubersetzer ($0.68 in chips) 
Seat 2: Gabryelods ($2.41 in chips) 
Seat 3: Lorpugo ($1.73 in chips) 
Seat 4: VNNBY ($1.87 in chips) 
Seat 5: nowisayhello ($2.09 in chips) 
Seat 6: dimon4ek1111 ($1.25 in chips) 
VNNBY: posts small blind $0.01
nowisayhello: posts big blind $0.02
*** HOLE CARDS ***
Dealt to Lorpugo [3c 2c]
dimon4ek1111: raises $0.04 to $0.06
Ubersetzer: calls $0.06
Gabryelods: folds 
Lorpugo: folds 
VNNBY: folds 
nowisayhello: folds 
*** FLOP *** [Qs Ac 7s]
dimon4ek1111: checks 
Ubersetzer: bets $0.08
dimon4ek1111: calls $0.08
*** TURN *** [Qs Ac 7s] [Jc]
dimon4ek1111: checks 
Ubersetzer: checks 
*** RIVER *** [Qs Ac 7s Jc] [5d]
dimon4ek1111: bets $0.15
Ubersetzer: folds 
Uncalled bet ($0.15) returned to dimon4ek1111
dimon4ek1111 collected $0.30 from pot
*** SUMMARY ***
Total pot $0.31 | Rake $0.01 
Board [Qs Ac 7s Jc 5d]
Seat 1: Ubersetzer folded on the River
Seat 2: Gabryelods folded before Flop (didn't bet)
Seat 3: Lorpugo (button) folded before Flop (didn't bet)
Seat 4: VNNBY (small blind) folded before Flop
Seat 5: nowisayhello (big blind) folded before Flop
Seat 6: dimon4ek1111 collected ($0.30)



PokerStars Hand #239467616077:  Hold'em No Limit ($0.01/$0.02 USD) - 2022/10/26 14:13:12 ET
Table 'Proteus III' 6-max Seat #4 is the button
Seat 1: Ubersetzer ($0.54 in chips) 
Seat 2: Gabryelods ($2.41 in chips) 
Seat 3: Lorpugo ($1.73 in chips) 
Seat 4: VNNBY ($1.86 in chips) 
Seat 5: nowisayhello ($2.07 in chips) 
Seat 6: dimon4ek1111 ($1.41 in chips) 
nowisayhello: posts small blind $0.01
dimon4ek1111: posts big blind $0.02
*** HOLE CARDS ***
Dealt to Lorpugo [Js 2h]
Ubersetzer: raises $0.04 to $0.06
Gabryelods: folds 
Lorpugo: folds 
VNNBY: folds 
nowisayhello: folds 
dimon4ek1111: folds 
Uncalled bet ($0.04) returned to Ubersetzer
Ubersetzer collected $0.05 from pot
Ubersetzer: doesn't show hand 
*** SUMMARY ***
Total pot $0.05 | Rake $0 
Seat 1: Ubersetzer collected ($0.05)
Seat 2: Gabryelods folded before Flop (didn't bet)
Seat 3: Lorpugo folded before Flop (didn't bet)
Seat 4: VNNBY (button) folded before Flop (didn't bet)
Seat 5: nowisayhello (small blind) folded before Flop
Seat 6: dimon4ek1111 (big blind) folded before Flop



PokerStars Hand #239467621404:  Hold'em No Limit ($0.01/$0.02 USD) - 2022/10/26 14:13:27 ET
Table 'Proteus III' 6-max Seat #5 is the button
Seat 1: Ubersetzer ($0.57 in chips) 
Seat 2: Gabryelods ($2.41 in chips) 
Seat 3: Lorpugo ($1.73 in chips) 
Seat 4: VNNBY ($1.86 in chips) 
Seat 5: nowisayhello ($2.06 in chips) 
Seat 6: dimon4ek1111 ($1.39 in chips) 
dimon4ek1111: posts small blind $0.01
Ubersetzer: posts big blind $0.02
*** HOLE CARDS ***
Dealt to Lorpugo [Kc 5s]
Gabryelods: raises $0.02 to $0.04
Lorpugo: folds 
VNNBY: folds 
nowisayhello: folds 
dimon4ek1111: raises $0.10 to $0.14
Ubersetzer: folds 
Gabryelods: folds 
Uncalled bet ($0.10) returned to dimon4ek1111
dimon4ek1111 collected $0.10 from pot
*** SUMMARY ***
Total pot $0.10 | Rake $0 
Seat 1: Ubersetzer (big blind) folded before Flop
Seat 2: Gabryelods folded before Flop
Seat 3: Lorpugo folded before Flop (didn't bet)
Seat 4: VNNBY folded before Flop (didn't bet)
Seat 5: nowisayhello (button) folded before Flop (didn't bet)
Seat 6: dimon4ek1111 (small blind) collected ($0.10)



PokerStars Hand #239467631368:  Hold'em No Limit ($0.01/$0.02 USD) - 2022/10/26 14:13:54 ET
Table 'Proteus III' 6-max Seat #6 is the button
Seat 1: Ubersetzer ($0.55 in chips) 
Seat 2: Gabryelods ($2.37 in chips) 
Seat 3: Lorpugo ($1.73 in chips) 
Seat 4: VNNBY ($1.86 in chips) 
Seat 5: nowisayhello ($2.06 in chips) 
Seat 6: dimon4ek1111 ($1.45 in chips) 
Ubersetzer: posts small blind $0.01
Gabryelods: posts big blind $0.02
*** HOLE CARDS ***
Dealt to Lorpugo [3s 7s]
Lorpugo: folds 
VNNBY: folds 
nowisayhello: folds 
dimon4ek1111: raises $0.04 to $0.06
Ubersetzer: folds 
Gabryelods: folds 
Uncalled bet ($0.04) returned to dimon4ek1111
dimon4ek1111 collected $0.05 from pot
*** SUMMARY ***
Total pot $0.05 | Rake $0 
Seat 1: Ubersetzer (small blind) folded before Flop
Seat 2: Gabryelods (big blind) folded before Flop
Seat 3: Lorpugo folded before Flop (didn't bet)
Seat 4: VNNBY folded before Flop (didn't bet)
Seat 5: nowisayhello folded before Flop (didn't bet)
Seat 6: dimon4ek1111 (button) collected ($0.05)



PokerStars Hand #239467636253:  Hold'em No Limit ($0.01/$0.02 USD) - 2022/10/26 14:14:08 ET
Table 'Proteus III' 6-max Seat #1 is the button
Seat 1: Ubersetzer ($0.54 in chips) 
Seat 2: Gabryelods ($2.35 in chips) 
Seat 3: Lorpugo ($1.73 in chips) 
Seat 4: VNNBY ($1.86 in chips) 
Seat 5: nowisayhello ($2.06 in chips) 
Seat 6: dimon4ek1111 ($1.48 in chips) 
Gabryelods: posts small blind $0.01
Lorpugo: posts big blind $0.02
*** HOLE CARDS ***
Dealt to Lorpugo [9h Qh]
VNNBY: raises $0.03 to $0.05
nowisayhello: folds 
dimon4ek1111: folds 
Ubersetzer: calls $0.05
Gabryelods: calls $0.04
Lorpugo: calls $0.03
*** FLOP *** [Th 3c 8d]
Gabryelods: checks 
Lorpugo: checks 
VNNBY: checks 
Ubersetzer: checks 
*** TURN *** [Th 3c 8d] [4c]
Gabryelods: checks 
Lorpugo: bets $0.06
VNNBY: folds 
Ubersetzer: folds 
Gabryelods: folds 
Uncalled bet ($0.06) returned to Lorpugo
Lorpugo collected $0.19 from pot
Lorpugo: doesn't show hand 
*** SUMMARY ***
Total pot $0.20 | Rake $0.01 
Board [Th 3c 8d 4c]
Seat 1: Ubersetzer (button) folded on the Turn
Seat 2: Gabryelods (small blind) folded on the Turn
Seat 3: Lorpugo (big blind) collected ($0.19)
Seat 4: VNNBY folded on the Turn
Seat 5: nowisayhello folded before Flop (didn't bet)
Seat 6: dimon4ek1111 folded before Flop (didn't bet)



PokerStars Hand #239467663636:  Hold'em No Limit ($0.01/$0.02 USD) - 2022/10/26 14:15:21 ET
Table 'Proteus III' 6-max Seat #3 is the button
Seat 1: Ubersetzer ($0.49 in chips) 
Seat 3: Lorpugo ($1.87 in chips) 
Seat 4: VNNBY ($1.81 in chips) 
Seat 5: nowisayhello ($2.06 in chips) 
Seat 6: dimon4ek1111 ($1.48 in chips) 
VNNBY: posts small blind $0.01
nowisayhello: posts big blind $0.02
*** HOLE CARDS ***
Dealt to Lorpugo [9s Qs]
dimon4ek1111: raises $0.04 to $0.06
Ubersetzer: folds 
Lorpugo: calls $0.06
VNNBY: folds 
nowisayhello: folds 
*** FLOP *** [Ah 6h 5c]
dimon4ek1111: bets $0.07
Lorpugo: folds 
Uncalled bet ($0.07) returned to dimon4ek1111
dimon4ek1111 collected $0.14 from pot
*** SUMMARY ***
Total pot $0.15 | Rake $0.01 
Board [Ah 6h 5c]
Seat 1: Ubersetzer folded before Flop (didn't bet)
Seat 3: Lorpugo (button) folded on the Flop
Seat 4: VNNBY (small blind) folded before Flop
Seat 5: nowisayhello (big blind) folded before Flop
Seat 6: dimon4ek1111 collected ($0.14)



PokerStars Hand #239467676173:  Hold'em No Limit ($0.01/$0.02 USD) - 2022/10/26 14:15:55 ET
Table 'Proteus III' 6-max Seat #4 is the button
Seat 1: Ubersetzer ($0.49 in chips) 
Seat 3: Lorpugo ($1.81 in chips) 
Seat 4: VNNBY ($1.80 in chips) 
Seat 5: nowisayhello ($2.04 in chips) 
Seat 6: dimon4ek1111 ($1.56 in chips) 
nowisayhello: posts small blind $0.01
dimon4ek1111: posts big blind $0.02
*** HOLE CARDS ***
Dealt to Lorpugo [4d 3d]
Ubersetzer: folds 
Lorpugo: raises $0.02 to $0.04
VNNBY: raises $0.08 to $0.12
nowisayhello: folds 
dimon4ek1111: folds 
Lorpugo: calls $0.08
*** FLOP *** [Jc Td 9s]
Lorpugo: checks 
VNNBY: bets $0.08
Lorpugo: folds 
Uncalled bet ($0.08) returned to VNNBY
VNNBY collected $0.26 from pot
VNNBY: doesn't show hand 
*** SUMMARY ***
Total pot $0.27 | Rake $0.01 
Board [Jc Td 9s]
Seat 1: Ubersetzer folded before Flop (didn't bet)
Seat 3: Lorpugo folded on the Flop
Seat 4: VNNBY (button) collected ($0.26)
Seat 5: nowisayhello (small blind) folded before Flop
Seat 6: dimon4ek1111 (big blind) folded before Flop



PokerStars Hand #239467685909:  Hold'em No Limit ($0.01/$0.02 USD) - 2022/10/26 14:16:22 ET
Table 'Proteus III' 6-max Seat #5 is the button
Seat 1: Ubersetzer ($0.49 in chips) 
Seat 3: Lorpugo ($1.69 in chips) 
Seat 4: VNNBY ($1.94 in chips) 
Seat 5: nowisayhello ($2.03 in chips) 
Seat 6: dimon4ek1111 ($1.54 in chips) 
dimon4ek1111: posts small blind $0.01
Ubersetzer: posts big blind $0.02
*** HOLE CARDS ***
Dealt to Lorpugo [4d 5d]
Lorpugo: raises $0.02 to $0.04
VNNBY: folds 
nowisayhello: folds 
dimon4ek1111: folds 
Ubersetzer: folds 
Uncalled bet ($0.02) returned to Lorpugo
Lorpugo collected $0.05 from pot
Lorpugo: doesn't show hand 
*** SUMMARY ***
Total pot $0.05 | Rake $0 
Seat 1: Ubersetzer (big blind) folded before Flop
Seat 3: Lorpugo collected ($0.05)
Seat 4: VNNBY folded before Flop (didn't bet)
Seat 5: nowisayhello (button) folded before Flop (didn't bet)
Seat 6: dimon4ek1111 (small blind) folded before Flop



PokerStars Hand #239467690231:  Hold'em No Limit ($0.01/$0.02 USD) - 2022/10/26 14:16:33 ET
Table 'Proteus III' 6-max Seat #6 is the button
Seat 1: Ubersetzer ($0.47 in chips) 
Seat 3: Lorpugo ($1.72 in chips) 
Seat 4: VNNBY ($1.94 in chips) 
Seat 5: nowisayhello ($2.03 in chips) 
Seat 6: dimon4ek1111 ($1.53 in chips) 
Ubersetzer: posts small blind $0.01
Lorpugo: posts big blind $0.02
*** HOLE CARDS ***
Dealt to Lorpugo [3d Ac]
VNNBY: folds 
nowisayhello: folds 
dimon4ek1111: folds 
Ubersetzer: folds 
Uncalled bet ($0.01) returned to Lorpugo
Lorpugo collected $0.02 from pot
Lorpugo: doesn't show hand 
*** SUMMARY ***
Total pot $0.02 | Rake $0 
Seat 1: Ubersetzer (small blind) folded before Flop
Seat 3: Lorpugo (big blind) collected ($0.02)
Seat 4: VNNBY folded before Flop (didn't bet)
Seat 5: nowisayhello folded before Flop (didn't bet)
Seat 6: dimon4ek1111 (button) folded before Flop (didn't bet)



PokerStars Hand #239467693344:  Hold'em No Limit ($0.01/$0.02 USD) - 2022/10/26 14:16:42 ET
Table 'Proteus III' 6-max Seat #1 is the button
Seat 1: Ubersetzer ($0.46 in chips) 
Seat 3: Lorpugo ($1.73 in chips) 
Seat 4: VNNBY ($1.94 in chips) 
Seat 5: nowisayhello ($2.03 in chips) 
Seat 6: dimon4ek1111 ($1.53 in chips) 
Lorpugo: posts small blind $0.01
VNNBY: posts big blind $0.02
*** HOLE CARDS ***
Dealt to Lorpugo [9d 3s]
nowisayhello: raises $0.03 to $0.05
dimon4ek1111: folds 
Ubersetzer: folds 
Lorpugo: folds 
VNNBY: folds 
Uncalled bet ($0.03) returned to nowisayhello
nowisayhello collected $0.05 from pot
nowisayhello: doesn't show hand 
*** SUMMARY ***
Total pot $0.05 | Rake $0 
Seat 1: Ubersetzer (button) folded before Flop (didn't bet)
Seat 3: Lorpugo (small blind) folded before Flop
Seat 4: VNNBY (big blind) folded before Flop
Seat 5: nowisayhello collected ($0.05)
Seat 6: dimon4ek1111 folded before Flop (didn't bet)



PokerStars Hand #239467697447:  Hold'em No Limit ($0.01/$0.02 USD) - 2022/10/26 14:16:53 ET
Table 'Proteus III' 6-max Seat #3 is the button
Seat 1: Ubersetzer ($0.46 in chips) 
Seat 3: Lorpugo ($1.72 in chips) 
Seat 4: VNNBY ($1.92 in chips) 
Seat 5: nowisayhello ($2.06 in chips) 
Seat 6: dimon4ek1111 ($1.53 in chips) 
VNNBY: posts small blind $0.01
nowisayhello: posts big blind $0.02
*** HOLE CARDS ***
Dealt to Lorpugo [4h 3d]
dimon4ek1111: raises $0.02 to $0.04
Ubersetzer: calls $0.04
Lorpugo: folds 
VNNBY: folds 
nowisayhello: raises $0.14 to $0.18
dimon4ek1111: calls $0.14
Ubersetzer: folds 
*** FLOP *** [4c Qh 2d]
nowisayhello: bets $0.20
dimon4ek1111: calls $0.20
*** TURN *** [4c Qh 2d] [3h]
nowisayhello: bets $1.68 and is all-in
dimon4ek1111: calls $1.15 and is all-in
Uncalled bet ($0.53) returned to nowisayhello
*** RIVER *** [4c Qh 2d 3h] [7h]
*** SHOW DOWN ***
nowisayhello: shows [Kc Kh] (a pair of Kings)
dimon4ek1111: shows [3c 3s] (three of a kind, Threes)
dimon4ek1111 collected $3 from pot
*** SUMMARY ***
Total pot $3.11 | Rake $0.11 
Board [4c Qh 2d 3h 7h]
Seat 1: Ubersetzer folded before Flop
Seat 3: Lorpugo (button) folded before Flop (didn't bet)
Seat 4: VNNBY (small blind) folded before Flop
Seat 5: nowisayhello (big blind) showed [Kc Kh] and lost with a pair of Kings
Seat 6: dimon4ek1111 showed [3c 3s] and won ($3) with three of a kind, Threes



PokerStars Hand #239467721377:  Hold'em No Limit ($0.01/$0.02 USD) - 2022/10/26 14:17:58 ET
Table 'Proteus III' 6-max Seat #4 is the button
Seat 1: Ubersetzer ($0.42 in chips) 
Seat 3: Lorpugo ($1.72 in chips) 
Seat 4: VNNBY ($1.91 in chips) 
Seat 5: nowisayhello ($2 in chips) 
Seat 6: dimon4ek1111 ($3 in chips) 
nowisayhello: posts small blind $0.01
dimon4ek1111: posts big blind $0.02
*** HOLE CARDS ***
Dealt to Lorpugo [Jh 5d]
Ubersetzer: folds 
Lorpugo: folds 
VNNBY: raises $0.03 to $0.05
nowisayhello: raises $0.12 to $0.17
dimon4ek1111: folds 
VNNBY: calls $0.12
*** FLOP *** [2c As Qs]
nowisayhello: bets $0.18
VNNBY: folds 
Uncalled bet ($0.18) returned to nowisayhello
nowisayhello collected $0.35 from pot
nowisayhello: doesn't show hand 
*** SUMMARY ***
Total pot $0.36 | Rake $0.01 
Board [2c As Qs]
Seat 1: Ubersetzer folded before Flop (didn't bet)
Seat 3: Lorpugo folded before Flop (didn't bet)
Seat 4: VNNBY (button) folded on the Flop
Seat 5: nowisayhello (small blind) collected ($0.35)
Seat 6: dimon4ek1111 (big blind) folded before Flop



PokerStars Hand #239467734968:  Hold'em No Limit ($0.01/$0.02 USD) - 2022/10/26 14:18:35 ET
Table 'Proteus III' 6-max Seat #5 is the button
Seat 1: Ubersetzer ($0.42 in chips) 
Seat 3: Lorpugo ($1.72 in chips) 
Seat 4: VNNBY ($1.74 in chips) 
Seat 5: nowisayhello ($2.18 in chips) 
Seat 6: dimon4ek1111 ($2.98 in chips) 
dimon4ek1111: posts small blind $0.01
Ubersetzer: posts big blind $0.02
*** HOLE CARDS ***
Dealt to Lorpugo [7h 2s]
Lorpugo: folds 
VNNBY: folds 
nowisayhello: raises $0.03 to $0.05
dimon4ek1111: raises $0.12 to $0.17
Ubersetzer: folds 
nowisayhello: calls $0.12
*** FLOP *** [Ks Tc 8c]
dimon4ek1111: bets $0.37
nowisayhello: folds 
Uncalled bet ($0.37) returned to dimon4ek1111
dimon4ek1111 collected $0.35 from pot
*** SUMMARY ***
Total pot $0.36 | Rake $0.01 
Board [Ks Tc 8c]
Seat 1: Ubersetzer (big blind) folded before Flop
Seat 3: Lorpugo folded before Flop (didn't bet)
Seat 4: VNNBY folded before Flop (didn't bet)
Seat 5: nowisayhello (button) folded on the Flop
Seat 6: dimon4ek1111 (small blind) collected ($0.35)



PokerStars Hand #239467753116:  Hold'em No Limit ($0.01/$0.02 USD) - 2022/10/26 14:19:24 ET
Table 'Proteus III' 6-max Seat #6 is the button
Seat 1: Ubersetzer ($0.40 in chips) 
Seat 2: Gabryelods ($2.30 in chips) 
Seat 3: Lorpugo ($1.72 in chips) 
Seat 4: VNNBY ($1.74 in chips) 
Seat 5: nowisayhello ($2.01 in chips) 
Seat 6: dimon4ek1111 ($3.16 in chips) 
Ubersetzer: posts small blind $0.01
Gabryelods: posts big blind $0.02
*** HOLE CARDS ***
Dealt to Lorpugo [Td 7s]
Lorpugo: folds 
VNNBY: folds 
nowisayhello: folds 
dimon4ek1111: raises $0.04 to $0.06
Ubersetzer: folds 
Gabryelods: folds 
Uncalled bet ($0.04) returned to dimon4ek1111
dimon4ek1111 collected $0.05 from pot
*** SUMMARY ***
Total pot $0.05 | Rake $0 
Seat 1: Ubersetzer (small blind) folded before Flop
Seat 2: Gabryelods (big blind) folded before Flop
Seat 3: Lorpugo folded before Flop (didn't bet)
Seat 4: VNNBY folded before Flop (didn't bet)
Seat 5: nowisayhello folded before Flop (didn't bet)
Seat 6: dimon4ek1111 (button) collected ($0.05)



PokerStars Hand #239467762333:  Hold'em No Limit ($0.01/$0.02 USD) - 2022/10/26 14:19:49 ET
Table 'Proteus III' 6-max Seat #1 is the button
Seat 1: Ubersetzer ($0.39 in chips) 
Seat 2: Gabryelods ($2.28 in chips) 
Seat 3: Lorpugo ($1.72 in chips) 
Seat 4: VNNBY ($1.74 in chips) 
Seat 5: nowisayhello ($2.01 in chips) 
Seat 6: dimon4ek1111 ($3.19 in chips) 
Gabryelods: posts small blind $0.01
Lorpugo: posts big blind $0.02
*** HOLE CARDS ***
Dealt to Lorpugo [4h 5h]
VNNBY: folds 
nowisayhello: raises $0.03 to $0.05
dimon4ek1111: folds 
Ubersetzer: calls $0.05
Gabryelods: folds 
Lorpugo: calls $0.03
*** FLOP *** [3h 2h 9d]
Lorpugo: checks 
nowisayhello: checks 
Ubersetzer: checks 
*** TURN *** [3h 2h 9d] [2d]
Lorpugo: bets $0.26
nowisayhello: folds 
Ubersetzer: folds 
Uncalled bet ($0.26) returned to Lorpugo
Lorpugo collected $0.15 from pot
Lorpugo: doesn't show hand 
*** SUMMARY ***
Total pot $0.16 | Rake $0.01 
Board [3h 2h 9d 2d]
Seat 1: Ubersetzer (button) folded on the Turn
Seat 2: Gabryelods (small blind) folded before Flop
Seat 3: Lorpugo (big blind) collected ($0.15)
Seat 4: VNNBY folded before Flop (didn't bet)
Seat 5: nowisayhello folded on the Turn
Seat 6: dimon4ek1111 folded before Flop (didn't bet)



PokerStars Hand #239467785894:  Hold'em No Limit ($0.01/$0.02 USD) - 2022/10/26 14:20:54 ET
Table 'Proteus III' 6-max Seat #2 is the button
Seat 1: Ubersetzer ($0.34 in chips) 
Seat 2: Gabryelods ($2.27 in chips) 
Seat 3: Lorpugo ($1.82 in chips) 
Seat 4: VNNBY ($1.74 in chips) 
Seat 5: nowisayhello ($2 in chips) 
Seat 6: dimon4ek1111 ($3.19 in chips) 
Lorpugo: posts small blind $0.01
VNNBY: posts big blind $0.02
*** HOLE CARDS ***
Dealt to Lorpugo [8d 3d]
nowisayhello: folds 
dimon4ek1111: folds 
Ubersetzer: folds 
Gabryelods has timed out
Gabryelods: folds 
Lorpugo: raises $0.04 to $0.06
VNNBY: calls $0.04
*** FLOP *** [3h Tc 4s]
Lorpugo: bets $0.04
VNNBY: raises $0.08 to $0.12
Lorpugo: calls $0.08
*** TURN *** [3h Tc 4s] [Ks]
Lorpugo: checks 
VNNBY: bets $0.20
Lorpugo: folds 
Uncalled bet ($0.20) returned to VNNBY
VNNBY collected $0.35 from pot
VNNBY: doesn't show hand 
*** SUMMARY ***
Total pot $0.36 | Rake $0.01 
Board [3h Tc 4s Ks]
Seat 1: Ubersetzer folded before Flop (didn't bet)
Seat 2: Gabryelods (button) folded before Flop (didn't bet)
Seat 3: Lorpugo (small blind) folded on the Turn
Seat 4: VNNBY (big blind) collected ($0.35)
Seat 5: nowisayhello folded before Flop (didn't bet)
Seat 6: dimon4ek1111 folded before Flop (didn't bet)



PokerStars Hand #239467815411:  Hold'em No Limit ($0.01/$0.02 USD) - 2022/10/26 14:22:13 ET
Table 'Proteus III' 6-max Seat #3 is the button
Seat 1: Ubersetzer ($0.34 in chips) 
Seat 2: Gabryelods ($2.27 in chips) 
Seat 3: Lorpugo ($1.64 in chips) 
Seat 4: VNNBY ($1.91 in chips) 
Seat 5: nowisayhello ($2 in chips) 
Seat 6: dimon4ek1111 ($3.19 in chips) 
VNNBY: posts small blind $0.01
nowisayhello: posts big blind $0.02
*** HOLE CARDS ***
Dealt to Lorpugo [4h 5d]
dimon4ek1111: folds 
Ubersetzer: folds 
Gabryelods: calls $0.02
Lorpugo: folds 
VNNBY: folds 
nowisayhello: checks 
*** FLOP *** [8d Qd Jh]
nowisayhello: checks 
Gabryelods: bets $0.03
nowisayhello: folds 
Uncalled bet ($0.03) returned to Gabryelods
Gabryelods collected $0.05 from pot
Gabryelods: doesn't show hand 
*** SUMMARY ***
Total pot $0.05 | Rake $0 
Board [8d Qd Jh]
Seat 1: Ubersetzer folded before Flop (didn't bet)
Seat 2: Gabryelods collected ($0.05)
Seat 3: Lorpugo (button) folded before Flop (didn't bet)
Seat 4: VNNBY (small blind) folded before Flop
Seat 5: nowisayhello (big blind) folded on the Flop
Seat 6: dimon4ek1111 folded before Flop (didn't bet)



PokerStars Hand #239467828897:  Hold'em No Limit ($0.01/$0.02 USD) - 2022/10/26 14:22:50 ET
Table 'Proteus III' 6-max Seat #4 is the button
Seat 1: Ubersetzer ($0.34 in chips) 
Seat 2: Gabryelods ($2.30 in chips) 
Seat 3: Lorpugo ($1.64 in chips) 
Seat 4: VNNBY ($1.90 in chips) 
Seat 5: nowisayhello ($1.98 in chips) 
Seat 6: dimon4ek1111 ($3.19 in chips) 
nowisayhello: posts small blind $0.01
dimon4ek1111: posts big blind $0.02
*** HOLE CARDS ***
Dealt to Lorpugo [Ks Tc]
Ubersetzer: raises $0.04 to $0.06
Gabryelods: folds 
Lorpugo: folds 
VNNBY: folds 
nowisayhello: folds 
dimon4ek1111: folds 
Uncalled bet ($0.04) returned to Ubersetzer
Ubersetzer collected $0.05 from pot
Ubersetzer: doesn't show hand 
*** SUMMARY ***
Total pot $0.05 | Rake $0 
Seat 1: Ubersetzer collected ($0.05)
Seat 2: Gabryelods folded before Flop (didn't bet)
Seat 3: Lorpugo folded before Flop (didn't bet)
Seat 4: VNNBY (button) folded before Flop (didn't bet)
Seat 5: nowisayhello (small blind) folded before Flop
Seat 6: dimon4ek1111 (big blind) folded before Flop



PokerStars Hand #239467832673:  Hold'em No Limit ($0.01/$0.02 USD) - 2022/10/26 14:23:00 ET
Table 'Proteus III' 6-max Seat #5 is the button
Seat 1: Ubersetzer ($0.37 in chips) 
Seat 2: Gabryelods ($2.30 in chips) 
Seat 3: Lorpugo ($1.64 in chips) 
Seat 4: VNNBY ($1.90 in chips) 
Seat 5: nowisayhello ($2 in chips) 
Seat 6: dimon4ek1111 ($3.17 in chips) 
dimon4ek1111: posts small blind $0.01
Ubersetzer: posts big blind $0.02
*** HOLE CARDS ***
Dealt to Lorpugo [Qs Ts]
Gabryelods: calls $0.02
Lorpugo: raises $0.04 to $0.06
VNNBY: folds 
nowisayhello: folds 
dimon4ek1111: raises $0.12 to $0.18
Ubersetzer: folds 
Gabryelods: folds 
Lorpugo: calls $0.12
*** FLOP *** [Kd 6d 2h]
dimon4ek1111: bets $0.19
Lorpugo: calls $0.19
*** TURN *** [Kd 6d 2h] [5h]
dimon4ek1111: bets $0.20
Lorpugo: calls $0.20
*** RIVER *** [Kd 6d 2h 5h] [9c]
dimon4ek1111: bets $0.57
Lorpugo: folds 
Uncalled bet ($0.57) returned to dimon4ek1111
dimon4ek1111 collected $1.14 from pot
*** SUMMARY ***
Total pot $1.18 | Rake $0.04 
Board [Kd 6d 2h 5h 9c]
Seat 1: Ubersetzer (big blind) folded before Flop
Seat 2: Gabryelods folded before Flop
Seat 3: Lorpugo folded on the River
Seat 4: VNNBY folded before Flop (didn't bet)
Seat 5: nowisayhello (button) folded before Flop (didn't bet)
Seat 6: dimon4ek1111 (small blind) collected ($1.14)



PokerStars Hand #239467877424:  Hold'em No Limit ($0.01/$0.02 USD) - 2022/10/26 14:25:02 ET
Table 'Proteus III' 6-max Seat #6 is the button
Seat 1: Ubersetzer ($0.35 in chips) 
Seat 2: Gabryelods ($2.28 in chips) 
Seat 3: Lorpugo ($1.60 in chips) 
Seat 4: VNNBY ($1.90 in chips) 
Seat 5: nowisayhello ($2 in chips) 
Seat 6: dimon4ek1111 ($3.74 in chips) 
Ubersetzer: posts small blind $0.01
Gabryelods: posts big blind $0.02
*** HOLE CARDS ***
Dealt to Lorpugo [Ah 7h]
Lorpugo: raises $0.02 to $0.04
VNNBY: folds 
nowisayhello: calls $0.04
dimon4ek1111: folds 
Ubersetzer: folds 
Gabryelods: folds 
*** FLOP *** [4c 9h 2c]
Lorpugo: bets $0.04
nowisayhello: calls $0.04
*** TURN *** [4c 9h 2c] [Kd]
Lorpugo: bets $0.24
nowisayhello: folds 
Uncalled bet ($0.24) returned to Lorpugo
Lorpugo collected $0.18 from pot
Lorpugo: doesn't show hand 
*** SUMMARY ***
Total pot $0.19 | Rake $0.01 
Board [4c 9h 2c Kd]
Seat 1: Ubersetzer (small blind) folded before Flop
Seat 2: Gabryelods (big blind) folded before Flop
Seat 3: Lorpugo collected ($0.18)
Seat 4: VNNBY folded before Flop (didn't bet)
Seat 5: nowisayhello folded on the Turn
Seat 6: dimon4ek1111 (button) folded before Flop (didn't bet)



PokerStars Hand #239467891687:  Hold'em No Limit ($0.01/$0.02 USD) - 2022/10/26 14:25:41 ET
Table 'Proteus III' 6-max Seat #1 is the button
Seat 1: Ubersetzer ($0.34 in chips) 
Seat 2: Gabryelods ($2.26 in chips) 
Seat 3: Lorpugo ($1.70 in chips) 
Seat 4: VNNBY ($1.90 in chips) 
Seat 5: nowisayhello ($2 in chips) 
Seat 6: dimon4ek1111 ($3.74 in chips) 
Gabryelods: posts small blind $0.01
Lorpugo: posts big blind $0.02
*** HOLE CARDS ***
Dealt to Lorpugo [Jd Kc]
VNNBY: raises $0.03 to $0.05
nowisayhello: folds 
dimon4ek1111: calls $0.05
Ubersetzer: folds 
Gabryelods: folds 
Lorpugo: calls $0.03
*** FLOP *** [Ks 6h Qs]
Lorpugo: bets $0.10
VNNBY: folds 
dimon4ek1111: folds 
Uncalled bet ($0.10) returned to Lorpugo
Lorpugo collected $0.15 from pot
Lorpugo: doesn't show hand 
*** SUMMARY ***
Total pot $0.16 | Rake $0.01 
Board [Ks 6h Qs]
Seat 1: Ubersetzer (button) folded before Flop (didn't bet)
Seat 2: Gabryelods (small blind) folded before Flop
Seat 3: Lorpugo (big blind) collected ($0.15)
Seat 4: VNNBY folded on the Flop
Seat 5: nowisayhello folded before Flop (didn't bet)
Seat 6: dimon4ek1111 folded on the Flop



PokerStars Hand #239467906322:  Hold'em No Limit ($0.01/$0.02 USD) - 2022/10/26 14:26:22 ET
Table 'Proteus III' 6-max Seat #2 is the button
Seat 1: Ubersetzer ($0.34 in chips) 
Seat 2: Gabryelods ($2.25 in chips) 
Seat 3: Lorpugo ($1.80 in chips) 
Seat 4: VNNBY ($1.85 in chips) 
Seat 5: nowisayhello ($2 in chips) 
Seat 6: dimon4ek1111 ($3.69 in chips) 
Lorpugo: posts small blind $0.01
VNNBY: posts big blind $0.02
*** HOLE CARDS ***
Dealt to Lorpugo [2h Tc]
nowisayhello: folds 
dimon4ek1111: folds 
Ubersetzer: folds 
Gabryelods: calls $0.02
Lorpugo: calls $0.01
VNNBY: checks 
*** FLOP *** [Qh 9d 3s]
Lorpugo: checks 
VNNBY: checks 
Gabryelods: checks 
*** TURN *** [Qh 9d 3s] [2s]
Lorpugo: bets $0.02
VNNBY: folds 
Gabryelods: calls $0.02
*** RIVER *** [Qh 9d 3s 2s] [Ts]
Lorpugo: bets $0.10
Gabryelods: raises $0.10 to $0.20
Lorpugo: calls $0.10
*** SHOW DOWN ***
Gabryelods: shows [4d Ac] (high card Ace)
Lorpugo: shows [2h Tc] (two pair, Tens and Deuces)
Lorpugo collected $0.48 from pot
*** SUMMARY ***
Total pot $0.50 | Rake $0.02 
Board [Qh 9d 3s 2s Ts]
Seat 1: Ubersetzer folded before Flop (didn't bet)
Seat 2: Gabryelods (button) showed [4d Ac] and lost with high card Ace
Seat 3: Lorpugo (small blind) showed [2h Tc] and won ($0.48) with two pair, Tens and Deuces
Seat 4: VNNBY (big blind) folded on the Turn
Seat 5: nowisayhello folded before Flop (didn't bet)
Seat 6: dimon4ek1111 folded before Flop (didn't bet)



PokerStars Hand #239467928045:  Hold'em No Limit ($0.01/$0.02 USD) - 2022/10/26 14:27:21 ET
Table 'Proteus III' 6-max Seat #3 is the button
Seat 1: Ubersetzer ($0.34 in chips) 
Seat 2: Gabryelods ($2.01 in chips) 
Seat 3: Lorpugo ($2.04 in chips) 
Seat 4: VNNBY ($1.83 in chips) 
Seat 5: nowisayhello ($2 in chips) 
Seat 6: dimon4ek1111 ($3.69 in chips) 
VNNBY: posts small blind $0.01
nowisayhello: posts big blind $0.02
*** HOLE CARDS ***
Dealt to Lorpugo [9d 5s]
dimon4ek1111: folds 
Ubersetzer: folds 
Gabryelods: calls $0.02
Lorpugo: folds 
VNNBY: raises $0.06 to $0.08
nowisayhello: folds 
Gabryelods: calls $0.06
*** FLOP *** [Jc 4h Kc]
VNNBY: bets $0.09
Gabryelods: folds 
Uncalled bet ($0.09) returned to VNNBY
VNNBY collected $0.17 from pot
VNNBY: doesn't show hand 
*** SUMMARY ***
Total pot $0.18 | Rake $0.01 
Board [Jc 4h Kc]
Seat 1: Ubersetzer folded before Flop (didn't bet)
Seat 2: Gabryelods folded on the Flop
Seat 3: Lorpugo (button) folded before Flop (didn't bet)
Seat 4: VNNBY (small blind) collected ($0.17)
Seat 5: nowisayhello (big blind) folded before Flop
Seat 6: dimon4ek1111 folded before Flop (didn't bet)



PokerStars Hand #239467941837:  Hold'em No Limit ($0.01/$0.02 USD) - 2022/10/26 14:28:00 ET
Table 'Proteus III' 6-max Seat #4 is the button
Seat 1: Ubersetzer ($0.34 in chips) 
Seat 2: Gabryelods ($1.93 in chips) 
Seat 3: Lorpugo ($2.04 in chips) 
Seat 4: VNNBY ($1.92 in chips) 
Seat 5: nowisayhello ($1.98 in chips) 
Seat 6: dimon4ek1111 ($3.69 in chips) 
nowisayhello: posts small blind $0.01
dimon4ek1111: posts big blind $0.02
*** HOLE CARDS ***
Dealt to Lorpugo [9s 7d]
Ubersetzer: folds 
Gabryelods: calls $0.02
Lorpugo: folds 
VNNBY: folds 
nowisayhello: folds 
dimon4ek1111: checks 
*** FLOP *** [6s Jh 3c]
dimon4ek1111: checks 
Gabryelods: checks 
*** TURN *** [6s Jh 3c] [3h]
dimon4ek1111: bets $0.05
Gabryelods: calls $0.05
*** RIVER *** [6s Jh 3c 3h] [8h]
dimon4ek1111: bets $0.14
Gabryelods: folds 
Uncalled bet ($0.14) returned to dimon4ek1111
dimon4ek1111 collected $0.14 from pot
*** SUMMARY ***
Total pot $0.15 | Rake $0.01 
Board [6s Jh 3c 3h 8h]
Seat 1: Ubersetzer folded before Flop (didn't bet)
Seat 2: Gabryelods folded on the River
Seat 3: Lorpugo folded before Flop (didn't bet)
Seat 4: VNNBY (button) folded before Flop (didn't bet)
Seat 5: nowisayhello (small blind) folded before Flop
Seat 6: dimon4ek1111 (big blind) collected ($0.14)



PokerStars Hand #239467954705:  Hold'em No Limit ($0.01/$0.02 USD) - 2022/10/26 14:28:35 ET
Table 'Proteus III' 6-max Seat #5 is the button
Seat 1: Ubersetzer ($0.34 in chips) 
Seat 2: Gabryelods ($1.86 in chips) 
Seat 3: Lorpugo ($2.04 in chips) 
Seat 4: VNNBY ($1.92 in chips) 
Seat 5: nowisayhello ($2 in chips) 
Seat 6: dimon4ek1111 ($3.76 in chips) 
dimon4ek1111: posts small blind $0.01
Ubersetzer: posts big blind $0.02
*** HOLE CARDS ***
Dealt to Lorpugo [5d 2s]
Gabryelods: calls $0.02
Lorpugo: folds 
VNNBY: folds 
nowisayhello: folds 
dimon4ek1111: folds 
Ubersetzer: checks 
*** FLOP *** [Ad 6h 5h]
Ubersetzer: checks 
Gabryelods: bets $0.20
Ubersetzer: folds 
Uncalled bet ($0.20) returned to Gabryelods
Gabryelods collected $0.05 from pot
Gabryelods: doesn't show hand 
*** SUMMARY ***
Total pot $0.05 | Rake $0 
Board [Ad 6h 5h]
Seat 1: Ubersetzer (big blind) folded on the Flop
Seat 2: Gabryelods collected ($0.05)
Seat 3: Lorpugo folded before Flop (didn't bet)
Seat 4: VNNBY folded before Flop (didn't bet)
Seat 5: nowisayhello (button) folded before Flop (didn't bet)
Seat 6: dimon4ek1111 (small blind) folded before Flop



PokerStars Hand #239467971512:  Hold'em No Limit ($0.01/$0.02 USD) - 2022/10/26 14:29:22 ET
Table 'Proteus III' 6-max Seat #6 is the button
Seat 1: Ubersetzer ($0.32 in chips) 
Seat 2: Gabryelods ($1.89 in chips) 
Seat 3: Lorpugo ($2.04 in chips) 
Seat 4: VNNBY ($1.92 in chips) 
Seat 5: nowisayhello ($2 in chips) 
Seat 6: dimon4ek1111 ($3.75 in chips) 
Ubersetzer: posts small blind $0.01
Gabryelods: posts big blind $0.02
*** HOLE CARDS ***
Dealt to Lorpugo [6h Ac]
Lorpugo: raises $0.02 to $0.04
VNNBY: folds 
nowisayhello: folds 
dimon4ek1111: folds 
Ubersetzer: folds 
Gabryelods: folds 
Uncalled bet ($0.02) returned to Lorpugo
Lorpugo collected $0.05 from pot
Lorpugo: doesn't show hand 
*** SUMMARY ***
Total pot $0.05 | Rake $0 
Seat 1: Ubersetzer (small blind) folded before Flop
Seat 2: Gabryelods (big blind) folded before Flop
Seat 3: Lorpugo collected ($0.05)
Seat 4: VNNBY folded before Flop (didn't bet)
Seat 5: nowisayhello folded before Flop (didn't bet)
Seat 6: dimon4ek1111 (button) folded before Flop (didn't bet)



PokerStars Hand #239467978758:  Hold'em No Limit ($0.01/$0.02 USD) - 2022/10/26 14:29:42 ET
Table 'Proteus III' 6-max Seat #1 is the button
Seat 1: Ubersetzer ($0.31 in chips) 
Seat 2: Gabryelods ($1.87 in chips) 
Seat 3: Lorpugo ($2.07 in chips) 
Seat 4: VNNBY ($1.92 in chips) 
Seat 5: nowisayhello ($2 in chips) 
Seat 6: dimon4ek1111 ($3.75 in chips) 
Gabryelods: posts small blind $0.01
Lorpugo: posts big blind $0.02
*** HOLE CARDS ***
Dealt to Lorpugo [Kc Qh]
VNNBY: folds 
nowisayhello: folds 
dimon4ek1111: raises $0.04 to $0.06
Ubersetzer: folds 
Gabryelods: calls $0.05
Lorpugo: raises $0.18 to $0.24
dimon4ek1111: folds 
Gabryelods: folds 
Uncalled bet ($0.18) returned to Lorpugo
Lorpugo collected $0.18 from pot
Lorpugo: doesn't show hand 
*** SUMMARY ***
Total pot $0.18 | Rake $0 
Seat 1: Ubersetzer (button) folded before Flop (didn't bet)
Seat 2: Gabryelods (small blind) folded before Flop
Seat 3: Lorpugo (big blind) collected ($0.18)
Seat 4: VNNBY folded before Flop (didn't bet)
Seat 5: nowisayhello folded before Flop (didn't bet)
Seat 6: dimon4ek1111 folded before Flop



PokerStars Hand #239467993388:  Hold'em No Limit ($0.01/$0.02 USD) - 2022/10/26 14:30:22 ET
Table 'Proteus III' 6-max Seat #2 is the button
Seat 1: Ubersetzer ($0.31 in chips) 
Seat 2: Gabryelods ($1.81 in chips) 
Seat 3: Lorpugo ($2.19 in chips) 
Seat 4: VNNBY ($1.92 in chips) 
Seat 5: nowisayhello ($2 in chips) 
Seat 6: dimon4ek1111 ($3.69 in chips) 
Lorpugo: posts small blind $0.01
VNNBY: posts big blind $0.02
*** HOLE CARDS ***
Dealt to Lorpugo [3d Jh]
nowisayhello: folds 
dimon4ek1111: folds 
Ubersetzer: folds 
Gabryelods: folds 
Lorpugo: raises $0.04 to $0.06
VNNBY: folds 
Uncalled bet ($0.04) returned to Lorpugo
Lorpugo collected $0.04 from pot
Lorpugo: doesn't show hand 
*** SUMMARY ***
Total pot $0.04 | Rake $0 
Seat 1: Ubersetzer folded before Flop (didn't bet)
Seat 2: Gabryelods (button) folded before Flop (didn't bet)
Seat 3: Lorpugo (small blind) collected ($0.04)
Seat 4: VNNBY (big blind) folded before Flop
Seat 5: nowisayhello folded before Flop (didn't bet)
Seat 6: dimon4ek1111 folded before Flop (didn't bet)



PokerStars Hand #239467998093:  Hold'em No Limit ($0.01/$0.02 USD) - 2022/10/26 14:30:35 ET
Table 'Proteus III' 6-max Seat #3 is the button
Seat 1: Ubersetzer ($0.31 in chips) 
Seat 2: Gabryelods ($1.81 in chips) 
Seat 3: Lorpugo ($2.21 in chips) 
Seat 4: VNNBY ($1.90 in chips) 
Seat 5: nowisayhello ($2 in chips) 
Seat 6: dimon4ek1111 ($3.69 in chips) 
VNNBY: posts small blind $0.01
nowisayhello: posts big blind $0.02
*** HOLE CARDS ***
Dealt to Lorpugo [Kh Qc]
dimon4ek1111: folds 
Ubersetzer: folds 
Gabryelods: calls $0.02
Lorpugo: raises $0.07 to $0.09
VNNBY: folds 
nowisayhello: folds 
Gabryelods: folds 
Uncalled bet ($0.07) returned to Lorpugo
Lorpugo collected $0.07 from pot
Lorpugo: doesn't show hand 
*** SUMMARY ***
Total pot $0.07 | Rake $0 
Seat 1: Ubersetzer folded before Flop (didn't bet)
Seat 2: Gabryelods folded before Flop
Seat 3: Lorpugo (button) collected ($0.07)
Seat 4: VNNBY (small blind) folded before Flop
Seat 5: nowisayhello (big blind) folded before Flop
Seat 6: dimon4ek1111 folded before Flop (didn't bet)



PokerStars Hand #239468007584:  Hold'em No Limit ($0.01/$0.02 USD) - 2022/10/26 14:31:01 ET
Table 'Proteus III' 6-max Seat #4 is the button
Seat 1: Ubersetzer ($0.31 in chips) 
Seat 2: Gabryelods ($1.79 in chips) 
Seat 3: Lorpugo ($2.26 in chips) 
Seat 4: VNNBY ($1.89 in chips) 
Seat 5: nowisayhello ($1.98 in chips) 
Seat 6: dimon4ek1111 ($3.69 in chips) 
nowisayhello: posts small blind $0.01
dimon4ek1111: posts big blind $0.02
*** HOLE CARDS ***
Dealt to Lorpugo [Ks 6s]
Ubersetzer: folds 
Gabryelods: folds 
Lorpugo: raises $0.04 to $0.06
VNNBY: folds 
nowisayhello: calls $0.05
dimon4ek1111: raises $0.18 to $0.24
Lorpugo: folds 
nowisayhello: folds 
Uncalled bet ($0.18) returned to dimon4ek1111
dimon4ek1111 collected $0.18 from pot
*** SUMMARY ***
Total pot $0.18 | Rake $0 
Seat 1: Ubersetzer folded before Flop (didn't bet)
Seat 2: Gabryelods folded before Flop (didn't bet)
Seat 3: Lorpugo folded before Flop
Seat 4: VNNBY (button) folded before Flop (didn't bet)
Seat 5: nowisayhello (small blind) folded before Flop
Seat 6: dimon4ek1111 (big blind) collected ($0.18)



PokerStars Hand #239468017411:  Hold'em No Limit ($0.01/$0.02 USD) - 2022/10/26 14:31:27 ET
Table 'Proteus III' 6-max Seat #5 is the button
Seat 1: Ubersetzer ($0.31 in chips) 
Seat 2: Gabryelods ($1.79 in chips) 
Seat 3: Lorpugo ($2.20 in chips) 
Seat 4: VNNBY ($1.89 in chips) 
Seat 5: nowisayhello ($2 in chips) 
Seat 6: dimon4ek1111 ($3.81 in chips) 
dimon4ek1111: posts small blind $0.01
Ubersetzer: posts big blind $0.02
*** HOLE CARDS ***
Dealt to Lorpugo [5c 9d]
Gabryelods: folds 
Lorpugo: folds 
VNNBY: raises $0.03 to $0.05
nowisayhello: folds 
dimon4ek1111: folds 
Ubersetzer: calls $0.03
*** FLOP *** [7d Qs 9c]
Ubersetzer: checks 
VNNBY: bets $0.08
Ubersetzer: calls $0.08
*** TURN *** [7d Qs 9c] [4s]
Ubersetzer: checks 
VNNBY: bets $0.26
Ubersetzer: calls $0.18 and is all-in
Uncalled bet ($0.08) returned to VNNBY
*** RIVER *** [7d Qs 9c 4s] [8h]
*** SHOW DOWN ***
Ubersetzer: shows [Js Ks] (high card King)
VNNBY: shows [Ah As] (a pair of Aces)
VNNBY cashed out the hand for $0.45
*** SUMMARY ***
Total pot $0.63 | Rake $0.02 
Board [7d Qs 9c 4s 8h]
Seat 1: Ubersetzer (big blind) showed [Js Ks] and lost with high card King
Seat 2: Gabryelods folded before Flop (didn't bet)
Seat 3: Lorpugo folded before Flop (didn't bet)
Seat 4: VNNBY showed [Ah As] and won ($0.61) with a pair of Aces (pot not awarded as player cashed out)
Seat 5: nowisayhello (button) folded before Flop (didn't bet)
Seat 6: dimon4ek1111 (small blind) folded before Flop



PokerStars Hand #239468033212:  Hold'em No Limit ($0.01/$0.02 USD) - 2022/10/26 14:32:11 ET
Table 'Proteus III' 6-max Seat #6 is the button
Seat 2: Gabryelods ($1.79 in chips) 
Seat 3: Lorpugo ($2.20 in chips) 
Seat 4: VNNBY ($2.03 in chips) 
Seat 5: nowisayhello ($2 in chips) 
Seat 6: dimon4ek1111 ($3.80 in chips) 
Gabryelods: posts small blind $0.01
Lorpugo: posts big blind $0.02
*** HOLE CARDS ***
Dealt to Lorpugo [Ad 7s]
VNNBY: folds 
nowisayhello: folds 
dimon4ek1111: raises $0.04 to $0.06
Gabryelods: folds 
Lorpugo: calls $0.04
*** FLOP *** [3d 2d Td]
Lorpugo: checks 
dimon4ek1111: bets $0.08
Lorpugo: raises $0.10 to $0.18
dimon4ek1111: calls $0.10
*** TURN *** [3d 2d Td] [9s]
Lorpugo: bets $0.24
dimon4ek1111: calls $0.24
*** RIVER *** [3d 2d Td 9s] [5s]
Lorpugo: bets $1.30
dimon4ek1111: calls $1.30
*** SHOW DOWN ***
Lorpugo: shows [Ad 7s] (high card Ace)
dimon4ek1111: shows [Ts Jh] (a pair of Tens)
dimon4ek1111 collected $3.45 from pot
*** SUMMARY ***
Total pot $3.57 | Rake $0.12 
Board [3d 2d Td 9s 5s]
Seat 2: Gabryelods (small blind) folded before Flop
Seat 3: Lorpugo (big blind) showed [Ad 7s] and lost with high card Ace
Seat 4: VNNBY folded before Flop (didn't bet)
Seat 5: nowisayhello folded before Flop (didn't bet)
Seat 6: dimon4ek1111 (button) showed [Ts Jh] and won ($3.45) with a pair of Tens



PokerStars Hand #239468067653:  Hold'em No Limit ($0.01/$0.02 USD) - 2022/10/26 14:33:44 ET
Table 'Proteus III' 6-max Seat #2 is the button
Seat 1: Ubersetzer ($0.80 in chips) 
Seat 2: Gabryelods ($1.78 in chips) 
Seat 3: Lorpugo ($1.60 in chips) 
Seat 4: VNNBY ($2.03 in chips) 
Seat 5: nowisayhello ($2 in chips) 
Seat 6: dimon4ek1111 ($5.47 in chips) 
Lorpugo: posts small blind $0.01
VNNBY: posts big blind $0.02
Ubersetzer: posts small blind $0.01
*** HOLE CARDS ***
Dealt to Lorpugo [Qc 5d]
nowisayhello: calls $0.02
dimon4ek1111: folds 
dimon4ek1111 leaves the table
LongHart joins the table at seat #6 
Ubersetzer: folds 
Gabryelods: folds 
Lorpugo: calls $0.01
VNNBY: checks 
*** FLOP *** [Ac 4s 9s]
Lorpugo: checks 
VNNBY: checks 
nowisayhello: checks 
*** TURN *** [Ac 4s 9s] [Jh]
Lorpugo: checks 
VNNBY: bets $0.03
nowisayhello: calls $0.03
Lorpugo: folds 
*** RIVER *** [Ac 4s 9s Jh] [Kc]
VNNBY: bets $0.08
nowisayhello: folds 
Uncalled bet ($0.08) returned to VNNBY
VNNBY collected $0.13 from pot
VNNBY: doesn't show hand 
*** SUMMARY ***
Total pot $0.13 | Rake $0 
Board [Ac 4s 9s Jh Kc]
Seat 1: Ubersetzer folded before Flop (didn't bet)
Seat 2: Gabryelods (button) folded before Flop (didn't bet)
Seat 3: Lorpugo (small blind) folded on the Turn
Seat 4: VNNBY (big blind) collected ($0.13)
Seat 5: nowisayhello folded on the River
Seat 6: dimon4ek1111 folded before Flop (didn't bet)



PokerStars Hand #239468096078:  Hold'em No Limit ($0.01/$0.02 USD) - 2022/10/26 14:35:02 ET
Table 'Proteus III' 6-max Seat #3 is the button
Seat 1: Ubersetzer ($0.79 in chips) 
Seat 2: Gabryelods ($1.78 in chips) 
Seat 3: Lorpugo ($1.60 in chips) 
Seat 4: VNNBY ($2.11 in chips) 
Seat 5: nowisayhello ($2 in chips) 
VNNBY: posts small blind $0.01
nowisayhello: posts big blind $0.02
LongHart: sits out 
*** HOLE CARDS ***
Dealt to Lorpugo [Th Kh]
Ubersetzer: raises $0.04 to $0.06
Gabryelods: folds 
Lorpugo: calls $0.06
VNNBY: folds 
nowisayhello: calls $0.04
*** FLOP *** [Js 5h 3h]
nowisayhello: checks 
Ubersetzer: bets $0.18
Lorpugo: raises $1.36 to $1.54 and is all-in
nowisayhello: folds 
Ubersetzer: calls $0.55 and is all-in
Uncalled bet ($0.81) returned to Lorpugo
*** TURN *** [Js 5h 3h] [6c]
*** RIVER *** [Js 5h 3h 6c] [Tc]
*** SHOW DOWN ***
Ubersetzer: shows [Jc Jd] (three of a kind, Jacks)
Lorpugo: shows [Th Kh] (a pair of Tens)
Ubersetzer cashed out the hand for $1.16 | Cash Out Fee $0.01
*** SUMMARY ***
Total pot $1.65 | Rake $0.06 
Board [Js 5h 3h 6c Tc]
Seat 1: Ubersetzer showed [Jc Jd] and won ($1.59) with three of a kind, Jacks (pot not awarded as player cashed out)
Seat 2: Gabryelods folded before Flop (didn't bet)
Seat 3: Lorpugo (button) showed [Th Kh] and lost with a pair of Tens
Seat 4: VNNBY (small blind) folded before Flop
Seat 5: nowisayhello (big blind) folded on the Flop



PokerStars Hand #239468114584:  Hold'em No Limit ($0.01/$0.02 USD) - 2022/10/26 14:35:51 ET
Table 'Proteus III' 6-max Seat #4 is the button
Seat 1: Ubersetzer ($1.16 in chips) 
Seat 2: Gabryelods ($1.78 in chips) 
Seat 3: Lorpugo ($1.60 in chips) 
Seat 4: VNNBY ($2.10 in chips) 
Seat 5: nowisayhello ($2 in chips) 
Seat 6: LongHart ($2 in chips) 
nowisayhello: posts small blind $0.01
LongHart: posts big blind $0.02
*** HOLE CARDS ***
Dealt to Lorpugo [6d 5s]
Ubersetzer: folds 
Gabryelods: folds 
Lorpugo: folds 
VNNBY: folds 
nowisayhello: raises $0.03 to $0.05
LongHart: folds 
Uncalled bet ($0.03) returned to nowisayhello
nowisayhello collected $0.04 from pot
nowisayhello: doesn't show hand 
*** SUMMARY ***
Total pot $0.04 | Rake $0 
Seat 1: Ubersetzer folded before Flop (didn't bet)
Seat 2: Gabryelods folded before Flop (didn't bet)
Seat 3: Lorpugo folded before Flop (didn't bet)
Seat 4: VNNBY (button) folded before Flop (didn't bet)
Seat 5: nowisayhello (small blind) collected ($0.04)
Seat 6: LongHart (big blind) folded before Flop



PokerStars Hand #239468121807:  Hold'em No Limit ($0.01/$0.02 USD) - 2022/10/26 14:36:11 ET
Table 'Proteus III' 6-max Seat #5 is the button
Seat 1: Ubersetzer ($1.16 in chips) 
Seat 2: Gabryelods ($1.78 in chips) 
Seat 3: Lorpugo ($1.60 in chips) 
Seat 4: VNNBY ($2.10 in chips) 
Seat 5: nowisayhello ($2.02 in chips) 
Seat 6: LongHart ($1.98 in chips) 
LongHart: posts small blind $0.01
Ubersetzer: posts big blind $0.02
*** HOLE CARDS ***
Dealt to Lorpugo [6d 5c]
Gabryelods: folds 
Lorpugo: folds 
VNNBY: raises $0.03 to $0.05
nowisayhello: folds 
LongHart: folds 
Ubersetzer: folds 
Uncalled bet ($0.03) returned to VNNBY
VNNBY collected $0.05 from pot
VNNBY: doesn't show hand 
*** SUMMARY ***
Total pot $0.05 | Rake $0 
Seat 1: Ubersetzer (big blind) folded before Flop
Seat 2: Gabryelods folded before Flop (didn't bet)
Seat 3: Lorpugo folded before Flop (didn't bet)
Seat 4: VNNBY collected ($0.05)
Seat 5: nowisayhello (button) folded before Flop (didn't bet)
Seat 6: LongHart (small blind) folded before Flop



PokerStars Hand #239468131183:  Hold'em No Limit ($0.01/$0.02 USD) - 2022/10/26 14:36:36 ET
Table 'Proteus III' 6-max Seat #6 is the button
Seat 1: Ubersetzer ($1.14 in chips) 
Seat 2: Gabryelods ($1.78 in chips) 
Seat 3: Lorpugo ($1.60 in chips) 
Seat 4: VNNBY ($2.13 in chips) 
Seat 5: nowisayhello ($2.02 in chips) 
Seat 6: LongHart ($1.97 in chips) 
Ubersetzer: posts small blind $0.01
Gabryelods: posts big blind $0.02
*** HOLE CARDS ***
Dealt to Lorpugo [3h 9c]
Lorpugo: folds 
VNNBY: folds 
nowisayhello: folds 
LongHart: folds 
Ubersetzer: raises $0.06 to $0.08
Gabryelods: calls $0.06
*** FLOP *** [Jc Qd Jd]
Ubersetzer: checks 
Gabryelods: checks 
*** TURN *** [Jc Qd Jd] [4h]
Ubersetzer: checks 
Gabryelods: bets $0.08
Ubersetzer: folds 
Uncalled bet ($0.08) returned to Gabryelods
Gabryelods collected $0.15 from pot
Gabryelods: doesn't show hand 
*** SUMMARY ***
Total pot $0.16 | Rake $0.01 
Board [Jc Qd Jd 4h]
Seat 1: Ubersetzer (small blind) folded on the Turn
Seat 2: Gabryelods (big blind) collected ($0.15)
Seat 3: Lorpugo folded before Flop (didn't bet)
Seat 4: VNNBY folded before Flop (didn't bet)
Seat 5: nowisayhello folded before Flop (didn't bet)
Seat 6: LongHart (button) folded before Flop (didn't bet)



PokerStars Hand #239468145183:  Hold'em No Limit ($0.01/$0.02 USD) - 2022/10/26 14:37:14 ET
Table 'Proteus III' 6-max Seat #1 is the button
Seat 1: Ubersetzer ($1.06 in chips) 
Seat 2: Gabryelods ($1.85 in chips) 
Seat 3: Lorpugo ($1.60 in chips) 
Seat 4: VNNBY ($2.13 in chips) 
Seat 5: nowisayhello ($2.02 in chips) 
Seat 6: LongHart ($1.97 in chips) 
Gabryelods: posts small blind $0.01
Lorpugo: posts big blind $0.02
*** HOLE CARDS ***
Dealt to Lorpugo [7c Qh]
VNNBY: raises $0.03 to $0.05
nowisayhello: folds 
LongHart: folds 
Ubersetzer: folds 
Gabryelods: folds 
Lorpugo: folds 
Uncalled bet ($0.03) returned to VNNBY
VNNBY collected $0.05 from pot
VNNBY: doesn't show hand 
*** SUMMARY ***
Total pot $0.05 | Rake $0 
Seat 1: Ubersetzer (button) folded before Flop (didn't bet)
Seat 2: Gabryelods (small blind) folded before Flop
Seat 3: Lorpugo (big blind) folded before Flop
Seat 4: VNNBY collected ($0.05)
Seat 5: nowisayhello folded before Flop (didn't bet)
Seat 6: LongHart folded before Flop (didn't bet)



PokerStars Hand #239468154740:  Hold'em No Limit ($0.01/$0.02 USD) - 2022/10/26 14:37:40 ET
Table 'Proteus III' 6-max Seat #2 is the button
Seat 1: Ubersetzer ($1.06 in chips) 
Seat 2: Gabryelods ($1.84 in chips) 
Seat 3: Lorpugo ($1.60 in chips) 
Seat 4: VNNBY ($2.16 in chips) 
Seat 5: nowisayhello ($2.02 in chips) 
Seat 6: LongHart ($1.97 in chips) 
Lorpugo: posts small blind $0.01
VNNBY: posts big blind $0.02
*** HOLE CARDS ***
Dealt to Lorpugo [Ah 2c]
nowisayhello: folds 
LongHart: folds 
Ubersetzer: folds 
Gabryelods: folds 
Lorpugo: raises $0.04 to $0.06
VNNBY: folds 
Uncalled bet ($0.04) returned to Lorpugo
Lorpugo collected $0.04 from pot
*** SUMMARY ***
Total pot $0.04 | Rake $0 
Seat 1: Ubersetzer folded before Flop (didn't bet)
Seat 2: Gabryelods (button) folded before Flop (didn't bet)
Seat 3: Lorpugo (small blind) collected ($0.04)
Seat 4: VNNBY (big blind) folded before Flop
Seat 5: nowisayhello folded before Flop (didn't bet)
Seat 6: LongHart folded before Flop (didn't bet)



PokerStars Hand #239468165503:  Hold'em No Limit ($0.01/$0.02 USD) - 2022/10/26 14:38:09 ET
Table 'Proteus III' 6-max Seat #3 is the button
Seat 1: Ubersetzer ($1.06 in chips) 
Seat 2: Gabryelods ($1.84 in chips) 
Seat 3: Lorpugo ($1.62 in chips) 
Seat 4: VNNBY ($2.14 in chips) 
Seat 5: nowisayhello ($2.02 in chips) 
Seat 6: LongHart ($1.97 in chips) 
VNNBY: posts small blind $0.01
nowisayhello: posts big blind $0.02
*** HOLE CARDS ***
Dealt to Lorpugo [2s Js]
LongHart: folds 
Ubersetzer: folds 
Gabryelods: folds 
Lorpugo: raises $0.04 to $0.06
VNNBY: folds 
nowisayhello: folds 
Uncalled bet ($0.04) returned to Lorpugo
Lorpugo collected $0.05 from pot
Lorpugo: doesn't show hand 
*** SUMMARY ***
Total pot $0.05 | Rake $0 
Seat 1: Ubersetzer folded before Flop (didn't bet)
Seat 2: Gabryelods folded before Flop (didn't bet)
Seat 3: Lorpugo (button) collected ($0.05)
Seat 4: VNNBY (small blind) folded before Flop
Seat 5: nowisayhello (big blind) folded before Flop
Seat 6: LongHart folded before Flop (didn't bet)



PokerStars Hand #239468174865:  Hold'em No Limit ($0.01/$0.02 USD) - 2022/10/26 14:38:34 ET
Table 'Proteus III' 6-max Seat #4 is the button
Seat 1: Ubersetzer ($1.06 in chips) 
Seat 2: Gabryelods ($1.84 in chips) 
Seat 3: Lorpugo ($1.65 in chips) 
Seat 4: VNNBY ($2.13 in chips) 
Seat 5: nowisayhello ($2 in chips) 
Seat 6: LongHart ($1.97 in chips) 
nowisayhello: posts small blind $0.01
LongHart: posts big blind $0.02
*** HOLE CARDS ***
Dealt to Lorpugo [9s 4s]
Ubersetzer: raises $0.04 to $0.06
Gabryelods: folds 
Lorpugo: folds 
VNNBY: folds 
nowisayhello: folds 
LongHart: folds 
Uncalled bet ($0.04) returned to Ubersetzer
Ubersetzer collected $0.05 from pot
Ubersetzer: doesn't show hand 
*** SUMMARY ***
Total pot $0.05 | Rake $0 
Seat 1: Ubersetzer collected ($0.05)
Seat 2: Gabryelods folded before Flop (didn't bet)
Seat 3: Lorpugo folded before Flop (didn't bet)
Seat 4: VNNBY (button) folded before Flop (didn't bet)
Seat 5: nowisayhello (small blind) folded before Flop
Seat 6: LongHart (big blind) folded before Flop



